,Total Vote,"Joseph R. Biden, Jr.",Donald J. Trump,pr,pd,rmargin,rabs,sFIPS
0,27769,7503,19838,0.7144,0.2702,0.44420000000000004,12335,01001
1,109681,24578,83544,0.7617,0.2241,0.5376000000000001,58966,01003
2,10518,4816,5622,0.5345,0.4579,0.0766,806,01005
3,9595,1986,7525,0.7843,0.207,0.5773,5539,01007
4,27588,2640,24711,0.8957,0.0957,0.8,22071,01009
5,4614,3446,1146,0.2484,0.747,-0.4986,-2300,01011
6,9487,3965,5458,0.5753,0.4179,0.15740000000000004,1493,01013
7,50982,15216,35101,0.6885,0.2985,0.39,19885,01015
8,15284,6365,8753,0.5727,0.4164,0.1563,2388,01017
9,12302,1624,10583,0.8603,0.132,0.7283,8959,01019
10,19310,3073,16085,0.833,0.1591,0.6738999999999999,13012,01021
11,7464,3127,4296,0.5756,0.4189,0.1567,1169,01023
12,13135,5755,7324,0.5576,0.4381,0.1195,1569,01025
13,6930,1267,5601,0.8082,0.1828,0.6254000000000001,4334,01027
14,7227,675,6484,0.8972,0.0934,0.8038,5809,01029
15,22274,5076,16899,0.7587,0.2279,0.5308,11823,01031
16,27887,8343,19203,0.6886,0.2992,0.38939999999999997,10860,01033
17,6441,2966,3442,0.5344,0.4605,0.07389999999999997,476,01035
18,5479,1796,3631,0.6627,0.3278,0.3349,1835,01037
19,17431,2721,14586,0.8368,0.1561,0.6807,11865,01039
20,6617,1700,4864,0.7351,0.2569,0.47819999999999996,3164,01041
21,41852,4478,36880,0.8812,0.107,0.7742,32402,01043
22,19739,5170,14303,0.7246,0.2619,0.4627,9133,01045
23,17865,12230,5524,0.3092,0.6846,-0.3754,-6706,01047
24,29355,4281,24767,0.8437,0.1458,0.6979,20486,01049
25,41028,10367,30164,0.7352,0.2527,0.4825,19797,01051
26,15909,4918,10869,0.6832,0.3091,0.37410000000000004,5951,01053
27,47727,11567,35528,0.7444,0.2424,0.502,23961,01055
28,8766,1395,7300,0.8328,0.1591,0.6737,5905,01057
29,12578,2086,10376,0.8249,0.1658,0.6591,8290,01059
30,12545,1595,10848,0.8647,0.1271,0.7376,9253,01061
31,4776,3884,875,0.1832,0.8134,-0.6302,-3009,01063
32,7899,4663,3192,0.4041,0.5903,-0.18620000000000003,-1471,01065
33,9298,2606,6607,0.7106,0.2803,0.4303,4001,01067
34,46175,12917,32618,0.7064,0.2798,0.42660000000000003,19701,01069
35,23636,3717,19670,0.8322,0.1573,0.6749,15953,01071
36,325846,181688,138843,0.4261,0.5576,-0.1315,-42845,01073
37,7193,978,6174,0.8583,0.136,0.7222999999999999,5196,01075
38,44340,11915,31721,0.7154,0.2687,0.44670000000000004,19806,01077
39,16032,3562,12322,0.7686,0.2222,0.5464,8760,01079
40,71452,27860,42221,0.5909,0.3899,0.20099999999999996,14361,01081
41,49233,13672,34640,0.7036,0.2777,0.4259,20968,01083
42,6835,4972,1836,0.2686,0.7274,-0.45880000000000004,-3136,01085
43,8721,7108,1541,0.1767,0.8149,-0.6382,-5567,01087
44,194770,87286,102780,0.5277,0.4482,0.07949999999999996,15494,01089
45,10900,5488,5343,0.4902,0.5035,-0.013299999999999923,-145,01091
46,13807,1463,12205,0.884,0.106,0.778,10742,01093
47,39655,5943,33191,0.837,0.1499,0.6870999999999999,27248,01095
48,183179,79474,101243,0.5527,0.4339,0.11879999999999996,21769,01097
49,10668,4455,6147,0.5762,0.4176,0.15860000000000002,1692,01099
50,99140,64529,33311,0.336,0.6509,-0.3149,-31218,01101
51,53723,13234,39664,0.7383,0.2463,0.492,26430,01103
52,5230,3860,1339,0.256,0.738,-0.482,-2521,01105
53,9668,4022,5594,0.5786,0.416,0.16260000000000002,1572,01107
54,13842,5636,8042,0.581,0.4072,0.17379999999999995,2406,01109
55,10837,2203,8559,0.7898,0.2033,0.5864999999999999,6356,01111
56,21328,11228,9864,0.4625,0.5264,-0.06389999999999996,-1364,01113
57,44441,7744,36166,0.8138,0.1743,0.6395,28422,01115
58,114957,33268,79700,0.6933,0.2894,0.40390000000000004,46432,01117
59,6291,4648,1598,0.254,0.7388,-0.4848,-3050,01119
60,35662,13138,22235,0.6235,0.3684,0.25510000000000005,9097,01121
61,20992,5859,14963,0.7128,0.2791,0.4337,9104,01123
62,90169,37765,51117,0.5669,0.4188,0.14809999999999995,13352,01125
63,31170,4834,26002,0.8342,0.1551,0.6791,21168,01127
64,8876,2258,6564,0.7395,0.2544,0.48510000000000003,4306,01129
65,5903,4048,1833,0.3105,0.6858,-0.37529999999999997,-2215,01131
66,11284,974,10195,0.9035,0.0863,0.8171999999999999,9221,01133
67,7361,3477,3511,0.477,0.4724,0.004599999999999993,34,02701
68,6161,2104,3674,0.5963,0.3415,0.2548,1570,02702
69,8421,1903,6076,0.7215,0.226,0.49550000000000005,4173,02703
70,10587,5345,4690,0.443,0.5049,-0.06190000000000001,-655,02704
71,8706,4204,4077,0.4683,0.4829,-0.014600000000000002,-127,02705
72,9518,3272,5770,0.6062,0.3438,0.26239999999999997,2498,02706
73,9664,2215,7027,0.7271,0.2292,0.4979,4812,02707
74,9957,1953,7618,0.7651,0.1961,0.569,5665,02708
75,11047,2769,7787,0.7049,0.2507,0.4542,5018,02709
76,11256,2727,8081,0.7179,0.2423,0.4756,5354,02710
77,10687,3130,7096,0.664,0.2929,0.37110000000000004,3966,02711
78,11281,2957,7893,0.6997,0.2621,0.4376,4936,02712
79,7765,2666,4652,0.5991,0.3433,0.25579999999999997,1986,02713
80,11534,4261,6714,0.5821,0.3694,0.21269999999999994,2453,02714
81,5593,2622,2671,0.4776,0.4688,0.00880000000000003,49,02715
82,8169,4274,3516,0.4304,0.5231,-0.0927,-758,02716
83,7270,4136,2810,0.3865,0.5688,-0.18229999999999996,-1326,02717
84,7759,4681,2760,0.3557,0.6033,-0.24759999999999993,-1921,02718
85,5338,3118,1975,0.37,0.5841,-0.21409999999999996,-1143,02719
86,7544,4881,2383,0.3159,0.647,-0.3311,-2498,02720
87,9481,5414,3690,0.3892,0.571,-0.18179999999999996,-1724,02721
88,9596,4553,4684,0.4881,0.4744,0.01369999999999999,131,02722
89,7797,3810,3655,0.4688,0.4887,-0.01990000000000003,-155,02723
90,10483,4736,5378,0.513,0.4517,0.06130000000000002,642,02724
91,9369,4600,4407,0.4704,0.491,-0.020600000000000007,-193,02725
92,10181,4558,5243,0.515,0.4477,0.06730000000000003,685,02726
93,9531,4844,4324,0.4537,0.5082,-0.05449999999999999,-520,02727
94,12832,6264,6162,0.4802,0.4882,-0.008000000000000007,-102,02728
95,10785,2985,7464,0.6921,0.2768,0.41530000000000006,4479,02729
96,10226,2638,7180,0.7021,0.258,0.44409999999999994,4542,02730
97,12482,5037,6971,0.5585,0.4036,0.15489999999999998,1934,02731
98,8362,3506,4440,0.531,0.4193,0.11170000000000002,934,02732
99,11015,7535,3059,0.2777,0.684,-0.40630000000000005,-4476,02733
100,10794,5763,4543,0.4209,0.5339,-0.11300000000000004,-1220,02734
101,10149,5011,4769,0.4699,0.4937,-0.023800000000000043,-242,02735
102,9330,3796,5114,0.5481,0.4068,0.14130000000000004,1318,02736
103,5168,2560,2358,0.4563,0.4954,-0.039100000000000024,-202,02737
104,5336,3202,1737,0.3255,0.6001,-0.27459999999999996,-1465,02738
105,5930,3580,1939,0.327,0.6037,-0.2767,-1641,02739
106,4628,2318,1994,0.4309,0.5009,-0.07,-324,02740
107,35271,23293,11442,0.3244,0.6605,-0.33609999999999995,-11851,04001
108,60667,23732,35557,0.5861,0.3912,0.19489999999999996,11825,04003
109,73631,44698,27052,0.3674,0.607,-0.23959999999999998,-17646,04005
110,27735,8943,18377,0.6626,0.3224,0.34019999999999995,9434,04007
111,15029,4034,10749,0.7152,0.2684,0.4467999999999999,6715,04009
112,3696,1182,2433,0.6583,0.3198,0.3385,1251,04011
113,7472,2236,5129,0.6864,0.2993,0.3871,2893,04012
114,2076032,1040774,995665,0.4796,0.5013,-0.02169999999999994,-45109,04013
115,104881,24831,78535,0.7488,0.2367,0.5121,53704,04015
116,51928,23383,27657,0.5326,0.4503,0.08229999999999998,4274,04017
117,522136,304981,207758,0.3979,0.5841,-0.18619999999999998,-97223,04019
118,185511,75106,107077,0.5772,0.4048,0.17240000000000005,31971,04021
119,19583,13138,6194,0.3163,0.671,-0.3547,-6944,04023
120,143639,49602,91527,0.6372,0.3453,0.2919,41925,04025
121,70069,32210,36534,0.5214,0.4597,0.06169999999999998,4324,04027
122,6292,1818,4304,0.684,0.2889,0.39510000000000006,2486,05001
123,7926,2125,5548,0.7,0.2681,0.43189999999999995,3423,05003
124,21008,4635,15836,0.7538,0.2206,0.5332,11201,05005
125,119917,42249,73965,0.6168,0.3523,0.2645,31716,05007
126,17114,3064,13652,0.7977,0.179,0.6187,10588,05009
127,3654,1214,2335,0.639,0.3322,0.3068,1121,05011
128,2182,479,1636,0.7498,0.2195,0.5303,1157,05013
129,11797,4023,7424,0.6293,0.341,0.28829999999999995,3401,05015
130,4103,2260,1752,0.427,0.5508,-0.12379999999999997,-508,05017
131,8394,3438,4616,0.5499,0.4095,0.14040000000000008,1178,05019
132,5183,962,4086,0.7883,0.1856,0.6027,3124,05021
133,12680,1988,10328,0.8145,0.1568,0.6577,8340,05023
134,3600,651,2867,0.7964,0.1808,0.6156,2216,05025
135,8617,2814,5500,0.6383,0.3266,0.3117,2686,05027
136,8685,2615,5694,0.6556,0.3011,0.3545,3079,05029
137,38508,11921,25558,0.6637,0.3095,0.35419999999999996,13637,05031
138,24090,4959,18607,0.7724,0.2058,0.5666,13648,05033
139,16368,8514,7333,0.448,0.5202,-0.07219999999999999,-1181,05035
140,6942,1772,4946,0.7125,0.2553,0.4572,3174,05037
141,2649,963,1573,0.5938,0.3635,0.2303,610,05039
142,4164,2016,1921,0.4613,0.4841,-0.022799999999999987,-95,05041
143,6908,2426,4349,0.6296,0.3512,0.27840000000000004,1923,05043
144,54429,18347,34421,0.6324,0.3371,0.29529999999999995,16074,05045
145,7129,1300,5677,0.7963,0.1824,0.6139,4377,05047
146,5119,1035,3961,0.7738,0.2022,0.5716000000000001,2926,05049
147,44198,14045,29069,0.6577,0.3178,0.3398999999999999,15024,05051
148,8200,1268,6794,0.8285,0.1546,0.6739,5526,05053
149,16099,3058,12670,0.787,0.1899,0.5971,9612,05055
150,6848,2138,4470,0.6527,0.3122,0.34049999999999997,2332,05057
151,12557,3082,9202,0.7328,0.2454,0.4874,6120,05059
152,4834,1340,3367,0.6965,0.2772,0.4193,2027,05061
153,14512,2806,11250,0.7752,0.1934,0.5818,8444,05063
154,5810,1021,4631,0.7971,0.1757,0.6214000000000001,3610,05065
155,5091,1365,3593,0.7058,0.2681,0.4377,2228,05067
156,25161,14981,9521,0.3784,0.5955,-0.21710000000000002,-5460,05069
157,9498,2283,6938,0.7305,0.2404,0.49010000000000004,4655,05071
158,2679,839,1757,0.6558,0.3132,0.34260000000000007,918,05073
159,5857,1080,4569,0.7801,0.1844,0.5957,3489,05075
160,2848,1423,1286,0.4515,0.4996,-0.048099999999999976,-137,05077
161,3875,1032,2729,0.7043,0.2663,0.43800000000000006,1697,05079
162,5177,1226,3715,0.7176,0.2368,0.4808,2489,05081
163,8225,1544,6441,0.7831,0.1877,0.5954,4897,05083
164,30663,6686,22884,0.7463,0.2181,0.5282,16198,05085
165,7351,1563,5658,0.7697,0.2126,0.5571,4095,05087
166,7503,1531,5783,0.7708,0.2041,0.5667,4252,05089
167,16528,4245,11920,0.7212,0.2568,0.4644,7675,05091
168,12341,4558,7296,0.5912,0.3693,0.22189999999999993,2738,05093
169,2816,1147,1545,0.5487,0.4073,0.14139999999999997,398,05095
170,3873,731,3046,0.7865,0.1887,0.5978,2315,05097
171,3358,1076,2133,0.6352,0.3204,0.31479999999999997,1057,05099
172,3998,709,3192,0.7984,0.1773,0.6211,2483,05101
173,9629,3995,5294,0.5498,0.4149,0.13489999999999996,1299,05103
174,4627,1012,3479,0.7519,0.2187,0.5332,2467,05105
175,6242,3623,2417,0.3872,0.5804,-0.19320000000000004,-1206,05107
176,4246,644,3519,0.8288,0.1517,0.6771,2875,05109
177,7521,1424,5918,0.7869,0.1893,0.5976,4494,05111
178,8490,1246,7035,0.8286,0.1468,0.6818,5789,05113
179,24430,5772,18081,0.7401,0.2362,0.5039,12309,05115
180,3495,654,2786,0.7971,0.1871,0.6100000000000001,2132,05117
181,169968,101947,63687,0.3747,0.5998,-0.22510000000000002,-38260,05119
182,6812,1215,5355,0.7861,0.1784,0.6077,4140,05121
183,7108,3604,3242,0.4561,0.507,-0.0509,-362,05123
184,56956,16060,39556,0.6945,0.282,0.41250000000000003,23496,05125
185,3551,483,2962,0.8341,0.136,0.6980999999999999,2479,05127
186,4019,588,3365,0.8373,0.1463,0.6910000000000001,2777,05129
187,47141,14487,31198,0.6618,0.3073,0.35450000000000004,16711,05131
188,5202,1116,3884,0.7466,0.2145,0.5321,2768,05133
189,7566,1398,5938,0.7848,0.1848,0.6000000000000001,4540,05135
190,5938,1180,4616,0.7774,0.1987,0.5787,3436,05137
191,16608,5584,10478,0.6309,0.3362,0.2947,4894,05139
192,7807,1593,6034,0.7729,0.204,0.5689000000000001,4441,05141
193,94273,43824,47504,0.5039,0.4649,0.039000000000000035,3680,05143
194,30884,5978,24182,0.783,0.1936,0.5894,18204,05145
195,2476,856,1543,0.6232,0.3457,0.27749999999999997,687,05147
196,6741,1284,5226,0.7753,0.1905,0.5848,3942,05149
197,774043,617659,136309,0.1761,0.7981,-0.622,-481350,06001
198,741,476,244,0.3293,0.6424,-0.3131,-232,06003
199,22395,8153,13585,0.6066,0.364,0.24260000000000004,5432,06005
200,102074,50426,48730,0.4774,0.4941,-0.016699999999999993,-1696,06007
201,27271,10046,16518,0.6057,0.3684,0.2373,6472,06009
202,7961,3239,4559,0.5727,0.4069,0.1658,1320,06011
203,581281,416386,152877,0.263,0.7163,-0.45330000000000004,-263509,06013
204,11454,4677,6461,0.5641,0.4084,0.15570000000000006,1784,06015
205,116150,51621,61838,0.5324,0.4444,0.08799999999999997,10217,06017
206,364908,193025,164464,0.4507,0.529,-0.07830000000000004,-28561,06019
207,11297,3995,7063,0.6252,0.3536,0.27159999999999995,3068,06021
208,69420,44768,21770,0.3136,0.6448,-0.33120000000000005,-22998,06023
209,56742,34678,20847,0.3674,0.6111,-0.24369999999999997,-13831,06025
210,9485,4634,4620,0.4871,0.4886,-0.0015000000000000013,-14,06027
211,305278,133366,164484,0.5388,0.4368,0.10199999999999992,31118,06029
212,43863,18699,24072,0.5488,0.4263,0.12249999999999994,5373,06031
213,28988,14941,13123,0.4527,0.5155,-0.06279999999999997,-1818,06033
214,12045,2799,8970,0.7447,0.2324,0.5123,6171,06035
215,4264818,3028885,1145530,0.2686,0.7103,-0.44170000000000004,-1883355,06037
216,53727,23168,29378,0.5468,0.4312,0.11559999999999993,6210,06039
217,155871,128288,24612,0.1579,0.8233,-0.6654,-103676,06041
218,10280,4088,5950,0.5788,0.3977,0.18109999999999998,1862,06043
219,43342,28782,13267,0.3061,0.6641,-0.35800000000000004,-15515,06045
220,90986,48991,39397,0.433,0.5384,-0.1054,-9594,06047
221,4367,1150,3109,0.7119,0.2633,0.4486,1959,06049
222,6737,4013,2513,0.373,0.5956,-0.22260000000000002,-1500,06051
223,163948,113953,46299,0.2824,0.6952,-0.41280000000000006,-67654,06053
224,72142,49817,20676,0.2866,0.6905,-0.4039,-29141,06055
225,64746,36359,26779,0.4136,0.5615,-0.14789999999999998,-9580,06057
226,1522273,814009,676498,0.4444,0.5348,-0.09040000000000004,-137511,06059
227,235102,106869,122488,0.521,0.4546,0.06640000000000001,15619,06061
228,11260,4561,6445,0.5724,0.4051,0.1673,1884,06063
229,997211,528340,449144,0.4504,0.5298,-0.07940000000000003,-79196,06065
230,718374,440808,259405,0.3611,0.6137,-0.25260000000000005,-181403,06067
231,28832,17628,10590,0.3673,0.6114,-0.24410000000000004,-7038,06069
232,841197,455859,366257,0.4354,0.542,-0.10660000000000003,-89602,06071
233,1601959,964650,600094,0.3746,0.6021,-0.22749999999999998,-364556,06073
234,443530,378156,56417,0.1272,0.8526,-0.7254,-321739,06075
235,289777,161137,121098,0.4179,0.5561,-0.13820000000000005,-40039,06077
236,159725,88310,67436,0.4222,0.5529,-0.13069999999999993,-20874,06079
237,374178,291496,75584,0.202,0.7789,-0.5769,-215912,06081
238,201459,129963,65736,0.3263,0.6452,-0.3189,-64227,06083
239,850622,617967,214612,0.2523,0.7264,-0.4741,-403355,06085
240,145684,114246,26937,0.1849,0.7844,-0.5994999999999999,-87309,06087
241,92935,30000,60789,0.6541,0.3228,0.33130000000000004,30789,06089
242,1947,730,1142,0.5865,0.3749,0.2116,412,06091
243,23472,9593,13290,0.5662,0.4087,0.15750000000000003,3697,06093
244,206822,131639,69306,0.3351,0.6365,-0.30139999999999995,-62333,06095
245,268338,199938,61825,0.2304,0.7452,-0.5147999999999999,-138113,06097
246,215979,105841,104145,0.4822,0.49,-0.007799999999999974,-1696,06099
247,42643,17367,24375,0.5716,0.4073,0.1643,7008,06101
248,28732,8911,19141,0.6662,0.3102,0.35600000000000004,10230,06103
249,6330,2851,3188,0.5036,0.4504,0.053200000000000025,337,06105
250,146874,66105,77579,0.5282,0.45,0.07819999999999999,11474,06107
251,30409,11978,17689,0.5817,0.3939,0.18780000000000002,5711,06109
252,422855,251388,162207,0.3836,0.5945,-0.21090000000000003,-89181,06111
253,97298,67598,27292,0.2805,0.6948,-0.41429999999999995,-40306,06113
254,29798,11230,17676,0.5932,0.3769,0.21629999999999994,6446,06115
255,236716,134202,95657,0.4041,0.5669,-0.16279999999999994,-38545,08001
256,7809,3759,3813,0.4883,0.4814,0.006900000000000017,54,08003
257,350173,213607,127323,0.3636,0.61,-0.2464,-86284,08005
258,9144,3738,5189,0.5675,0.4088,0.1587,1451,08007
259,2225,317,1867,0.8391,0.1425,0.6966,1550,08009
260,2274,732,1503,0.6609,0.3219,0.339,771,08011
261,206115,159089,42501,0.2062,0.7719,-0.5657000000000001,-116588,08013
262,46637,29077,16295,0.3494,0.6235,-0.27410000000000007,-12782,08014
263,13717,7160,6222,0.4536,0.5219,-0.06830000000000003,-938,08015
264,1136,131,993,0.8741,0.1153,0.7588,862,08017
265,6548,3604,2754,0.4206,0.5504,-0.12980000000000003,-850,08019
266,4333,1959,2286,0.5276,0.4521,0.07549999999999996,327,08021
267,2094,1311,741,0.3539,0.6261,-0.2722,-570,08023
268,1750,437,1271,0.7263,0.2497,0.4765999999999999,834,08025
269,3635,1112,2474,0.6806,0.3059,0.3747,1362,08027
270,19371,5887,13081,0.6753,0.3039,0.3714,7194,08029
271,393722,313293,71618,0.1819,0.7955,-0.6135999999999999,-241675,08031
272,1449,341,1089,0.7516,0.2353,0.5163,748,08033
273,231608,104653,121270,0.5236,0.4519,0.07169999999999993,16617,08035
274,29137,18588,9892,0.3395,0.6379,-0.2984,-8696,08037
275,18984,4490,14027,0.7389,0.2365,0.5024,9537,08039
276,378835,161941,202828,0.5354,0.4275,0.1079,40887,08041
277,25557,7369,17517,0.6854,0.2883,0.3971,10148,08043
278,30905,15427,14717,0.4762,0.4992,-0.022999999999999965,-710,08045
279,4186,2223,1833,0.4379,0.5311,-0.0932,-390,08047
280,9871,4710,4883,0.4947,0.4772,0.01749999999999996,173,08049
281,11189,7132,3735,0.3338,0.6374,-0.3036,-3397,08051
282,632,255,353,0.5585,0.4035,0.15499999999999997,98,08053
283,4406,2076,2203,0.5,0.4712,0.028799999999999992,127,08055
284,876,175,681,0.7774,0.1998,0.5776,506,08057
285,377363,218396,148417,0.3933,0.5788,-0.1855,-69979,08059
286,903,98,795,0.8804,0.1085,0.7718999999999999,697,08061
287,3871,662,3144,0.8122,0.171,0.6412,2482,08063
288,3961,2303,1497,0.3779,0.5814,-0.20350000000000001,-806,08065
289,35663,20548,14233,0.3991,0.5761,-0.17699999999999994,-6315,08067
290,224348,126120,91489,0.4078,0.5622,-0.15440000000000004,-34631,08069
291,7961,3497,4284,0.5381,0.4393,0.0988,787,08071
292,2651,470,2135,0.8054,0.1773,0.6281,1665,08073
293,10531,2218,8087,0.7679,0.2106,0.5573,5869,08075
294,90624,31536,56894,0.6278,0.348,0.27980000000000005,25358,08077
295,756,317,427,0.5648,0.4193,0.14549999999999996,110,08079
296,7026,1203,5670,0.807,0.1712,0.6358,4467,08081
297,15500,5836,9306,0.6004,0.3765,0.22390000000000004,3470,08083
298,24922,7687,16770,0.6729,0.3084,0.36450000000000005,9083,08085
299,13744,3876,9593,0.698,0.282,0.416,5717,08087
300,9576,3605,5756,0.6011,0.3765,0.22459999999999997,2151,08089
301,4020,2365,1577,0.3923,0.5883,-0.19600000000000006,-788,08091
302,12291,4903,6991,0.5688,0.3989,0.1699,2088,08093
303,2485,486,1958,0.7879,0.1956,0.5923,1472,08095
304,11957,8989,2780,0.2325,0.7518,-0.5193,-6209,08097
305,5561,1458,4008,0.7207,0.2622,0.4585,2550,08099
306,88301,43772,42252,0.4785,0.4957,-0.017199999999999993,-1520,08101
307,3691,561,3061,0.8293,0.152,0.6773,2500,08103
308,6305,2495,3660,0.5805,0.3957,0.18480000000000002,1165,08105
309,16876,10582,5925,0.3511,0.627,-0.2759,-4657,08107
310,3389,1884,1413,0.4169,0.5559,-0.13899999999999996,-471,08109
311,562,342,202,0.3594,0.6085,-0.24910000000000004,-140,08111
312,5147,3924,1136,0.2207,0.7624,-0.5417,-2788,08113
313,1446,301,1121,0.7752,0.2082,0.567,820,08115
314,18479,12631,5322,0.288,0.6835,-0.3955,-7309,08117
315,16939,5278,11241,0.6636,0.3116,0.352,5963,08119
316,3008,369,2595,0.8627,0.1227,0.74,2226,08121
317,166976,66060,96145,0.5758,0.3956,0.18019999999999997,30085,08123
318,4981,785,4107,0.8245,0.1576,0.6669,3322,08125
319,472969,297505,169039,0.3574,0.629,-0.2716,-128466,09001
320,449347,283368,159024,0.3539,0.6306,-0.27670000000000006,-124344,09003
321,107545,50164,55601,0.517,0.4665,0.05049999999999999,5437,09005
322,99207,56848,40665,0.4099,0.573,-0.16309999999999997,-16183,09007
323,417938,242629,169892,0.4065,0.5805,-0.17400000000000004,-72737,09009
324,139599,79459,57110,0.4091,0.5692,-0.16010000000000002,-22349,09011
325,80544,44006,34819,0.4323,0.5463,-0.11399999999999999,-9187,09013
326,57072,26701,29141,0.5106,0.4678,0.04280000000000006,2440,09015
327,87031,44552,41009,0.4712,0.5119,-0.040700000000000014,-3543,10001
328,287643,195034,88364,0.3072,0.6781,-0.37090000000000006,-106670,10003
329,129344,56682,71230,0.5507,0.4382,0.11249999999999999,14548,10005
330,344185,317323,18586,0.054,0.9215,-0.8674999999999999,-298737,11001
331,143059,89704,50972,0.3563,0.6271,-0.2708,-38732,12001
332,14083,2037,11911,0.8458,0.1447,0.7011000000000001,9874,12003
333,93213,25614,66097,0.7091,0.2748,0.43429999999999996,40483,12005
334,13649,3160,10334,0.7571,0.2315,0.5256,7174,12007
335,361661,148549,207883,0.5748,0.4108,0.16399999999999998,59334,12009
336,959727,618752,333409,0.3474,0.6448,-0.29740000000000005,-285343,12011
337,6537,1209,5274,0.8068,0.1849,0.6218999999999999,4065,12013
338,116555,42273,73243,0.6284,0.3627,0.26569999999999994,30970,12015
339,93387,27092,65352,0.6998,0.2901,0.40969999999999995,38260,12017
340,124657,38317,84480,0.6777,0.3074,0.37029999999999996,46163,12019
341,208286,77621,128950,0.6191,0.3727,0.2464,51329,12021
342,33092,8914,23836,0.7203,0.2694,0.4509000000000001,14922,12023
343,12676,4259,8313,0.6558,0.336,0.31980000000000003,4054,12027
344,8173,1365,6759,0.827,0.167,0.6599999999999999,5394,12029
345,494211,252556,233762,0.473,0.5111,-0.03810000000000002,-18794,12031
346,170862,70929,96674,0.5658,0.4151,0.15069999999999995,25745,12033
347,71858,28161,43043,0.599,0.3919,0.20709999999999995,14882,12035
348,6859,2120,4675,0.6816,0.3091,0.3725,2555,12037
349,23759,16153,7465,0.3142,0.6798,-0.3656,-8688,12039
350,9703,1700,7895,0.8137,0.1752,0.6385,6195,12041
351,5203,1385,3782,0.7269,0.2662,0.4607,2397,12043
352,8172,1985,6113,0.748,0.2429,0.5051,4128,12045
353,5840,1963,3815,0.6533,0.3361,0.3172,1852,12047
354,8502,2298,6122,0.7201,0.2703,0.4498,3824,12049
355,12956,4929,7906,0.6102,0.3804,0.22979999999999995,2977,12051
356,109149,37519,70412,0.6451,0.3437,0.3014,32893,12053
357,52244,16938,34873,0.6675,0.3242,0.3433,17935,12055
358,714063,376367,327398,0.4585,0.5271,-0.0686,-48969,12057
359,9078,924,8080,0.8901,0.1018,0.7883,7156,12059
360,97745,37844,58872,0.6023,0.3872,0.21509999999999996,21028,12061
361,22456,6766,15488,0.6897,0.3013,0.38839999999999997,8722,12063
362,8469,3897,4479,0.5289,0.4602,0.06870000000000004,582,12065
363,3662,510,3128,0.8542,0.1393,0.7149,2618,12067
364,211315,83505,125859,0.5956,0.3952,0.20040000000000002,42354,12069
365,394732,157695,233247,0.5909,0.3995,0.19139999999999996,75552,12071
366,163497,103517,57453,0.3514,0.6332,-0.2818,-46064,12073
367,23185,6205,16749,0.7224,0.2676,0.45480000000000004,10544,12075
368,3565,694,2846,0.7983,0.1947,0.6036,2152,12077
369,9394,3747,5576,0.5936,0.3989,0.19470000000000004,1829,12079
370,217482,90166,124987,0.5747,0.4146,0.16009999999999996,34821,12081
371,204718,74858,127826,0.6244,0.3657,0.25869999999999993,52968,12083
372,98945,36893,61168,0.6182,0.3729,0.24529999999999996,24275,12085
373,1158836,617864,532833,0.4598,0.5331,-0.07330000000000003,-85031,12086
374,48132,21881,25693,0.5338,0.4546,0.07920000000000005,3812,12087
375,58915,15564,42566,0.7225,0.2642,0.45830000000000004,27002,12089
376,116749,34248,79798,0.6835,0.2934,0.3901,45550,12091
377,15984,4390,11470,0.7176,0.2746,0.443,7080,12093
378,649201,395014,245398,0.378,0.6085,-0.23050000000000004,-149616,12095
379,172772,97297,73480,0.4253,0.5631,-0.13780000000000003,-23817,12097
380,774615,433572,334711,0.4321,0.5597,-0.1276,-98861,12099
381,302596,119073,179621,0.5936,0.3935,0.2001,60548,12101
382,561172,277450,276209,0.4922,0.4944,-0.0021999999999999797,-1241,12103
383,344035,145049,194586,0.5656,0.4216,0.14400000000000002,49537,12105
384,36423,10527,25514,0.7005,0.289,0.41150000000000003,14987,12107
385,177060,63850,110946,0.6266,0.3606,0.26600000000000007,47096,12109
386,172352,84137,86831,0.5038,0.4882,0.015600000000000003,2694,12111
387,107196,27612,77385,0.7219,0.2576,0.4643,49773,12113
388,271194,120110,148370,0.5471,0.4429,0.10420000000000001,28260,12115
389,261518,132528,125241,0.4789,0.5067,-0.027800000000000047,-7287,12117
390,92622,29341,62761,0.6776,0.3168,0.36079999999999995,33420,12119
391,21082,4485,16410,0.7784,0.2127,0.5657,11925,12121
392,10139,2299,7751,0.7645,0.2268,0.5377,5452,12123
393,6251,1053,5133,0.8211,0.1685,0.6526000000000001,4080,12125
394,308084,130575,173821,0.5642,0.4238,0.14040000000000002,43246,12127
395,18447,5351,12874,0.6979,0.2901,0.40779999999999994,7523,12129
396,43795,10338,32947,0.7523,0.2361,0.5162,22609,12131
397,12336,2347,9876,0.8006,0.1903,0.6103,7529,12133
398,8390,1784,6570,0.7831,0.2126,0.5705,4786,13001
399,3155,825,2300,0.729,0.2615,0.46749999999999997,1475,13003
400,4667,625,4017,0.8607,0.1339,0.7268,3392,13005
401,1555,652,897,0.5768,0.4193,0.15749999999999997,245,13007
402,18251,9140,8903,0.4878,0.5008,-0.013000000000000012,-237,13009
403,8801,932,7795,0.8857,0.1059,0.7798,6863,13011
404,37923,10453,26804,0.7068,0.2757,0.4311,16351,13013
405,50465,12091,37672,0.7465,0.2396,0.5069,25581,13015
406,6564,2393,4111,0.6263,0.3646,0.2617,1718,13017
407,7743,1269,6419,0.829,0.1639,0.6651,5150,13019
408,70711,43408,26559,0.3756,0.6139,-0.2383,-16849,13021
409,5708,1312,4329,0.7584,0.2299,0.5285,3017,13023
410,7749,700,6993,0.9024,0.0903,0.8120999999999999,6293,13025
411,7100,2791,4261,0.6001,0.393,0.20709999999999995,1470,13027
412,21337,6738,14240,0.6674,0.3158,0.35159999999999997,7502,13029
413,30088,11248,18387,0.6111,0.3738,0.23729999999999996,7139,13031
414,10682,5208,5400,0.5055,0.4875,0.01799999999999996,192,13033
415,11771,3274,8406,0.7141,0.2781,0.43599999999999994,5132,13035
416,2198,1263,923,0.4199,0.5746,-0.1547,-340,13037
417,23686,7967,15249,0.6438,0.3364,0.30740000000000006,7282,13039
418,4431,1269,3133,0.7071,0.2864,0.42069999999999996,1864,13043
419,54471,16236,37476,0.688,0.2981,0.38989999999999997,21240,13045
420,32591,6932,25167,0.7722,0.2127,0.5595,18235,13047
421,4568,1105,3419,0.7485,0.2419,0.5066,2314,13049
422,133414,78247,53232,0.399,0.5865,-0.1875,-25015,13051
423,1582,667,880,0.5563,0.4216,0.13470000000000004,213,13053
424,10050,1854,8064,0.8024,0.1845,0.6179,6210,13055
425,144809,42779,99585,0.6877,0.2954,0.3923,56806,13057
426,51350,36055,14450,0.2814,0.7022,-0.42080000000000006,-21605,13059
427,1435,791,637,0.4439,0.5512,-0.1073,-154,13061
428,112294,95466,15811,0.1408,0.8499,-0.7091,-79655,13063
429,2861,744,2105,0.7358,0.26,0.4758,1361,13065
430,393708,221847,165436,0.4202,0.5635,-0.14329999999999998,-56411,13067
431,15214,4511,10578,0.6953,0.2965,0.39880000000000004,6067,13069
432,16087,4190,11777,0.7321,0.2605,0.47159999999999996,7587,13071
433,80575,29232,50013,0.6207,0.3628,0.2579,20781,13073
434,7035,2059,4900,0.6965,0.2927,0.4038,2841,13075
435,76798,24210,51501,0.6706,0.3152,0.3554,27291,13077
436,6102,1615,4428,0.7257,0.2647,0.461,2813,13079
437,8033,2982,4985,0.6206,0.3712,0.24940000000000007,2003,13081
438,7434,1261,6066,0.816,0.1696,0.6464,4805,13083
439,16080,2486,13398,0.8332,0.1546,0.6786000000000001,10912,13085
440,11625,4782,6755,0.5811,0.4114,0.16969999999999996,1973,13087
441,370648,308162,58377,0.1575,0.8312,-0.6737000000000001,-249785,13089
442,8072,2172,5843,0.7239,0.2691,0.4548,3671,13091
443,4105,1911,2159,0.5259,0.4655,0.06040000000000001,248,13093
444,35286,24568,10441,0.2959,0.6962,-0.40030000000000004,-14127,13095
445,69112,42814,25454,0.3683,0.6195,-0.25120000000000003,-17360,13097
446,5188,2450,2710,0.5224,0.4722,0.05019999999999997,260,13099
447,1441,167,1256,0.8716,0.1159,0.7557,1089,13101
448,31569,7718,23361,0.74,0.2445,0.4955,15643,13103
449,9171,2879,6226,0.6789,0.3139,0.36499999999999994,3347,13105
450,9505,2886,6553,0.6894,0.3036,0.38580000000000003,3667,13107
451,4247,1324,2888,0.68,0.3117,0.36830000000000007,1564,13109
452,14849,2570,12169,0.8195,0.1731,0.6464,9599,13111
453,71995,33062,37956,0.5272,0.4592,0.068,4894,13113
454,41342,11917,28906,0.6992,0.2883,0.41090000000000004,16989,13115
455,129307,42208,85123,0.6583,0.3264,0.3319,42915,13117
456,10764,1593,9069,0.8425,0.148,0.6945,7476,13119
457,523844,380212,137247,0.262,0.7259,-0.4639,-242965,13121
458,16526,2932,13429,0.8126,0.1774,0.6352,10497,13123
459,1565,155,1402,0.8958,0.099,0.7968000000000001,1247,13125
460,41988,15882,25617,0.6101,0.3783,0.23179999999999995,9735,13127
461,24034,4384,19405,0.8074,0.1824,0.625,15021,13129
462,10706,3619,7034,0.657,0.338,0.319,3415,13131
463,11244,4087,7066,0.6284,0.3635,0.26489999999999997,2979,13133
464,414033,241994,166400,0.4019,0.5845,-0.18260000000000004,-75594,13135
465,20431,3562,16637,0.8143,0.1743,0.64,13075,13137
466,90539,25033,64183,0.7089,0.2765,0.43239999999999995,39150,13139
467,4153,2976,1154,0.2779,0.7166,-0.43870000000000003,-1822,13141
468,14246,1791,12330,0.8655,0.1257,0.7398,10539,13143
469,19990,5457,14319,0.7163,0.273,0.4433,8862,13145
470,12729,3157,9465,0.7436,0.248,0.49560000000000004,6308,13147
471,5394,824,4519,0.8378,0.1528,0.685,3695,13149
472,122984,73443,48259,0.3924,0.5971,-0.20469999999999994,-25184,13151
473,74833,32239,41540,0.5551,0.4308,0.12430000000000002,9301,13153
474,4168,1008,3134,0.7519,0.2418,0.5101,2126,13155
475,37673,7642,29502,0.7831,0.2028,0.5803,21860,13157
476,7644,1761,5822,0.7616,0.2304,0.5312000000000001,4061,13159
477,5771,1028,4695,0.8136,0.1781,0.6355,3667,13161
478,7639,4058,3537,0.463,0.5312,-0.06819999999999998,-521,13163
479,3455,1266,2161,0.6255,0.3664,0.25909999999999994,895,13165
480,4100,1222,2850,0.6951,0.298,0.39710000000000006,1628,13167
481,14934,4882,9940,0.6656,0.3269,0.33869999999999995,5058,13169
482,9046,2620,6331,0.6999,0.2897,0.41019999999999995,3711,13171
483,3576,1019,2509,0.7016,0.285,0.4166,1490,13173
484,22731,8074,14493,0.6376,0.3552,0.28239999999999993,6419,13175
485,16714,4558,12007,0.7184,0.2727,0.44570000000000004,7449,13177
486,21395,13104,7959,0.372,0.6125,-0.24050000000000005,-5145,13179
487,4641,1432,3173,0.6837,0.3086,0.3751,1741,13181
488,5657,2035,3527,0.6235,0.3597,0.26380000000000003,1492,13183
489,46359,20116,25692,0.5542,0.434,0.12020000000000003,5576,13185
490,15532,3126,12163,0.7831,0.2013,0.5818,9037,13187
491,10454,4168,6169,0.5901,0.3987,0.19139999999999996,2001,13189
492,6696,2612,4016,0.5998,0.3901,0.2097,1404,13191
493,4663,2858,1783,0.3824,0.6129,-0.23049999999999998,-1075,13193
494,14936,3411,11326,0.7583,0.2284,0.5299,7915,13195
495,3625,1312,2275,0.6276,0.3619,0.26570000000000005,963,13197
496,10877,4287,6524,0.5998,0.3941,0.2057,2237,13199
497,2834,748,2066,0.729,0.2639,0.46509999999999996,1318,13201
498,8961,3993,4935,0.5507,0.4455,0.10519999999999996,942,13205
499,15591,4385,11057,0.7092,0.2813,0.42790000000000006,6672,13207
500,3967,980,2960,0.7462,0.247,0.4992,1980,13209
501,11707,3353,8231,0.7031,0.2864,0.41669999999999996,4878,13211
502,15389,2301,12944,0.8411,0.1495,0.6916,10643,13213
503,80522,49446,30107,0.3739,0.6141,-0.24019999999999997,-19339,13215
504,54235,29789,23869,0.4401,0.5493,-0.10920000000000002,-5920,13217
505,25167,8162,16595,0.6594,0.3243,0.3351,8433,13219
506,8133,2439,5592,0.6876,0.2999,0.3877,3153,13221
507,85370,29695,54517,0.6386,0.3478,0.29079999999999995,24822,13223
508,12553,5922,6506,0.5183,0.4718,0.046499999999999986,584,13225
509,17168,2824,14110,0.8219,0.1645,0.6574,11286,13227
510,9047,1100,7898,0.873,0.1216,0.7514,6798,13229
511,10720,1505,9127,0.8514,0.1404,0.7110000000000001,7622,13231
512,17397,3657,13587,0.781,0.2102,0.5708,9930,13233
513,4081,1230,2815,0.6898,0.3014,0.38839999999999997,1585,13235
514,11854,3448,8291,0.6994,0.2908,0.4086,4843,13237
515,1106,497,604,0.5461,0.4494,0.09670000000000001,107,13239
516,9569,1984,7474,0.7811,0.2074,0.5737,5490,13241
517,3073,1671,1390,0.4523,0.5438,-0.09149999999999997,-281,13243
518,87005,59119,26780,0.3078,0.6795,-0.3717,-32339,13245
519,44676,31237,13014,0.2913,0.6991,-0.40780000000000005,-18223,13247
520,2275,462,1800,0.7912,0.2031,0.5881000000000001,1338,13249
521,6627,2661,3915,0.5908,0.4015,0.18929999999999997,1254,13251
522,3888,1256,2613,0.6721,0.323,0.3491,1357,13253
523,30209,11828,18104,0.5993,0.3915,0.20780000000000004,6276,13255
524,11886,2386,9367,0.7881,0.2008,0.5873,6981,13257
525,1990,1182,801,0.4025,0.594,-0.19149999999999995,-381,13259
526,12149,6314,5733,0.4719,0.5198,-0.047900000000000054,-581,13261
527,3522,2114,1392,0.3952,0.6002,-0.20499999999999996,-722,13263
528,928,561,360,0.3879,0.6045,-0.21660000000000001,-201,13265
529,8186,2062,6054,0.7396,0.2519,0.4877,3992,13267
530,3842,1388,2420,0.6299,0.3613,0.2686,1032,13269
531,4334,1488,2825,0.6518,0.3433,0.30850000000000005,1337,13271
532,4416,2376,2004,0.4538,0.538,-0.08420000000000005,-372,13273
533,21874,8708,12969,0.5929,0.3981,0.19479999999999997,4261,13275
534,16280,5318,10784,0.6624,0.3267,0.3357,5466,13277
535,10914,2938,7873,0.7214,0.2692,0.45220000000000005,4935,13279
536,7979,1550,6384,0.8001,0.1943,0.6058,4834,13281
537,3077,952,2101,0.6828,0.3094,0.37339999999999995,1149,13283
538,30046,11577,18142,0.6038,0.3853,0.21850000000000003,6565,13285
539,3791,1409,2349,0.6196,0.3717,0.24790000000000006,940,13287
540,4444,2044,2370,0.5333,0.4599,0.07340000000000002,326,13289
541,15558,2800,12650,0.8131,0.18,0.6331,9850,13291
542,12904,4203,8606,0.6669,0.3257,0.34120000000000006,4403,13293
543,29355,5770,23173,0.7894,0.1966,0.5928,17403,13295
544,51092,12683,37839,0.7406,0.2482,0.49240000000000006,25156,13297
545,14190,4169,9903,0.6979,0.2938,0.40409999999999996,5734,13299
546,2650,1468,1166,0.44,0.554,-0.11400000000000005,-302,13301
547,9476,4743,4668,0.4926,0.5005,-0.007899999999999963,-75,13303
548,12779,2688,9987,0.7815,0.2103,0.5711999999999999,7299,13305
549,1391,640,748,0.5377,0.4601,0.07759999999999995,108,13307
550,2285,689,1583,0.6928,0.3015,0.3913,894,13309
551,14816,2411,12222,0.8249,0.1627,0.6621999999999999,9811,13311
552,36766,10680,25644,0.6975,0.2905,0.40700000000000003,14964,13313
553,3279,861,2402,0.7325,0.2626,0.46990000000000004,1541,13315
554,5030,2160,2823,0.5612,0.4294,0.13180000000000003,663,13317
555,4770,2074,2665,0.5587,0.4348,0.12389999999999995,591,13319
556,9285,2395,6830,0.7356,0.2579,0.4777,4435,13321
557,87813,58731,26897,0.3063,0.6688,-0.36249999999999993,-31834,15001
558,382106,238869,136259,0.3566,0.6251,-0.2685,-102610,15003
559,33493,21225,11582,0.3458,0.6336,-0.28780000000000006,-9643,15007
560,71053,47305,22126,0.3114,0.6659,-0.35450000000000004,-25179,15009
561,259684,120539,130699,0.5033,0.4641,0.03919999999999996,10160,16001
562,2586,591,1941,0.7506,0.2285,0.5221,1350,16003
563,39780,14682,23331,0.5865,0.3691,0.21740000000000004,8649,16005
564,3316,350,2914,0.8788,0.1055,0.7733,2564,16007
565,4975,977,3878,0.7795,0.1964,0.5831,2901,16009
566,19996,4124,15295,0.7649,0.2062,0.5587,11171,16011
567,13289,8919,4032,0.3034,0.6712,-0.3678,-4887,16013
568,4822,1204,3485,0.7227,0.2497,0.473,2281,16015
569,27351,8310,18369,0.6716,0.3038,0.36779999999999996,10059,16017
570,54030,14254,37805,0.6997,0.2638,0.4359,23551,16019
571,6317,1220,4937,0.7815,0.1931,0.5884,3717,16021
572,1415,188,1202,0.8495,0.1329,0.7166,1014,16023
573,754,149,507,0.6724,0.1976,0.4748,358,16025
574,90463,25881,61759,0.6827,0.2861,0.39659999999999995,35878,16027
575,3416,431,2906,0.8507,0.1262,0.7245,2475,16029
576,9632,1464,7907,0.8209,0.152,0.6688999999999999,6443,16031
577,311,41,264,0.8489,0.1318,0.7171,223,16033
578,4419,877,3453,0.7814,0.1985,0.5829,2576,16035
579,2737,603,2089,0.7632,0.2203,0.5428999999999999,1486,16037
580,10213,2601,7246,0.7095,0.2547,0.45480000000000004,4645,16039
581,6664,657,5845,0.8771,0.0986,0.7785,5188,16041
582,6721,998,5548,0.8255,0.1485,0.677,4550,16043
583,9982,1803,7951,0.7965,0.1806,0.6159,6148,16045
584,6052,1256,4659,0.7698,0.2075,0.5623,3403,16047
585,9610,1561,7826,0.8144,0.1624,0.652,6265,16049
586,14181,1661,12099,0.8532,0.1171,0.7361,10438,16051
587,7815,1893,5734,0.7337,0.2422,0.49150000000000005,3841,16053
588,89511,24312,62837,0.702,0.2716,0.43039999999999995,38525,16055
589,20609,10236,9472,0.4596,0.4967,-0.037099999999999966,-764,16057
590,4739,1032,3592,0.758,0.2178,0.5402,2560,16059
591,1870,349,1489,0.7963,0.1866,0.6097,1140,16061
592,1941,414,1469,0.7568,0.2133,0.5435000000000001,1055,16063
593,17137,2666,13559,0.7912,0.1556,0.6356,10893,16065
594,7993,1550,6265,0.7838,0.1939,0.5899000000000001,4715,16067
595,20984,6686,13738,0.6547,0.3186,0.33609999999999995,7052,16069
596,2452,249,2148,0.876,0.1015,0.7745,1899,16071
597,4743,816,3819,0.8052,0.172,0.6332,3003,16073
598,11293,2161,8862,0.7847,0.1914,0.5932999999999999,6701,16075
599,3086,865,2116,0.6857,0.2803,0.4054,1251,16077
600,6049,1693,4216,0.697,0.2799,0.41709999999999997,2523,16079
601,6362,3318,2858,0.4492,0.5215,-0.07229999999999998,-460,16081
602,36511,9391,25897,0.7093,0.2572,0.45210000000000006,16506,16083
603,7063,2976,3947,0.5588,0.4214,0.13739999999999997,971,16085
604,5346,1073,4154,0.777,0.2007,0.5763,3081,16087
605,33527,8633,24220,0.7224,0.2575,0.46490000000000004,15587,17001
606,2618,1114,1486,0.5676,0.4255,0.1421,372,17003
607,8145,2288,5625,0.6906,0.2809,0.4097,3337,17005
608,24978,10542,13883,0.5558,0.422,0.13379999999999997,3341,17007
609,2521,486,1931,0.766,0.1928,0.5732,1445,17009
610,17433,6669,10411,0.5972,0.3825,0.21469999999999995,3742,17011
611,2772,677,2046,0.7381,0.2442,0.4939,1369,17013
612,8024,2748,5105,0.6362,0.3425,0.29369999999999996,2357,17015
613,5326,1615,3625,0.6806,0.3032,0.37739999999999996,2010,17017
614,95133,57067,35285,0.3709,0.5998,-0.2289,-21782,17019
615,16204,4335,11563,0.7136,0.2675,0.4461,7228,17021
616,8356,1993,6226,0.7451,0.2385,0.5065999999999999,4233,17023
617,6886,1129,5629,0.8175,0.164,0.6535,4500,17025
618,19169,4493,14304,0.7462,0.2344,0.5118,9811,17027
619,22608,8067,14037,0.6209,0.3569,0.264,5970,17029
620,2325152,1725973,558269,0.2401,0.7422,-0.5021,-1167704,17031
621,9425,2202,7043,0.7473,0.2336,0.5136999999999999,4841,17033
622,5832,1142,4601,0.7889,0.1958,0.5931000000000001,3459,17035
623,47828,24643,21905,0.458,0.5153,-0.05729999999999996,-2738,17037
624,8024,2191,5632,0.7019,0.2731,0.42879999999999996,3441,17039
625,8738,2335,6227,0.7126,0.2672,0.4454,3892,17041
626,485119,281222,193611,0.3991,0.5797,-0.18059999999999998,-87611,17043
627,8196,1887,6193,0.7556,0.2302,0.5254000000000001,4306,17045
628,3366,488,2833,0.8417,0.145,0.6967,2345,17047
629,19048,3716,15006,0.7878,0.1951,0.5927,11290,17049
630,10056,1826,8055,0.801,0.1816,0.6194000000000001,6229,17051
631,6953,1754,5048,0.726,0.2523,0.47369999999999995,3294,17053
632,18627,4760,13622,0.7313,0.2556,0.47569999999999996,8862,17055
633,16724,6503,9867,0.59,0.3888,0.2012,3364,17057
634,2674,622,2019,0.755,0.2326,0.5224,1397,17059
635,6237,1349,4770,0.7648,0.2163,0.5485,3421,17061
636,26693,9626,16523,0.619,0.3606,0.2584,6897,17063
637,4315,824,3432,0.7954,0.191,0.6044,2608,17065
638,9383,2315,6906,0.736,0.2467,0.48929999999999996,4591,17067
639,2162,449,1691,0.7821,0.2077,0.5744,1242,17069
640,3647,1187,2394,0.6564,0.3255,0.33089999999999997,1207,17071
641,25637,9797,15300,0.5968,0.3822,0.2146,5503,17073
642,14026,2908,10877,0.7755,0.2073,0.5681999999999999,7969,17075
643,22645,11181,10890,0.4809,0.4938,-0.012900000000000023,-291,17077
644,5576,1007,4494,0.806,0.1806,0.6254000000000001,3487,17079
645,17405,4608,12476,0.7168,0.2648,0.452,7868,17081
646,11938,2961,8712,0.7298,0.2481,0.4817,5751,17083
647,12495,5109,7166,0.5735,0.4089,0.16460000000000002,2057,17085
648,6450,1281,5059,0.7843,0.1986,0.5857,3778,17087
649,231852,130166,96775,0.4174,0.5614,-0.14400000000000002,-33391,17089
650,50039,20271,28532,0.5702,0.4051,0.16510000000000002,8261,17091
651,63974,33168,29492,0.461,0.5185,-0.05749999999999994,-3676,17093
652,23170,10703,12009,0.5183,0.462,0.05629999999999996,1306,17095
653,334218,204032,123594,0.3698,0.6106,-0.24080000000000001,-80438,17097
654,53591,22442,30113,0.5619,0.4188,0.14309999999999995,7671,17099
655,6411,1419,4886,0.7621,0.2213,0.5408,3467,17101
656,16397,6407,9630,0.5873,0.3907,0.19660000000000005,3223,17103
657,17175,4615,12208,0.7108,0.2687,0.4421,7593,17105
658,13295,3840,9136,0.6872,0.2889,0.39830000000000004,5296,17107
659,12328,4992,7027,0.57,0.405,0.16499999999999992,2035,17109
660,164586,78154,82260,0.4998,0.4749,0.024900000000000033,4106,17111
661,87195,43933,40502,0.4645,0.5039,-0.03939999999999999,-3431,17113
662,49394,19847,28589,0.5788,0.4018,0.177,8742,17115
663,24023,7365,16153,0.6724,0.3066,0.3658,8788,17117
664,137141,57836,76031,0.5544,0.4217,0.13269999999999998,18195,17119
665,17458,4524,12678,0.7262,0.2591,0.46709999999999996,8154,17121
666,6334,2005,4197,0.6626,0.3165,0.34609999999999996,2192,17123
667,6766,1985,4654,0.6879,0.2934,0.39449999999999996,2669,17125
668,6813,1725,4997,0.7335,0.2532,0.48030000000000006,3272,17127
669,6928,2022,4764,0.6876,0.2919,0.3957,2742,17129
670,8914,3280,5418,0.6078,0.368,0.2398,2138,17131
671,21148,6569,14142,0.6687,0.3106,0.3581,7573,17133
672,13726,3905,9544,0.6953,0.2845,0.41080000000000005,5639,17135
673,15334,5076,9950,0.6489,0.3311,0.3178,4874,17137
674,6744,1662,4964,0.7361,0.2464,0.48969999999999997,3302,17139
675,26270,9428,16248,0.6185,0.3589,0.25960000000000005,6820,17141
676,83978,43578,38252,0.4555,0.519,-0.0635,-5326,17143
677,10072,2612,7313,0.7261,0.2594,0.46669999999999995,4701,17145
678,9822,3329,6248,0.6361,0.3389,0.2972,2919,17147
679,7949,1484,6332,0.7966,0.1867,0.6099,4848,17149
680,2175,433,1722,0.7917,0.1991,0.5926,1289,17151
681,2624,891,1699,0.6475,0.3396,0.30789999999999995,808,17153
682,3390,1338,1993,0.5879,0.3947,0.19319999999999998,655,17155
683,14891,3592,11076,0.7438,0.2412,0.5026,7484,17157
684,8063,1830,6089,0.7552,0.227,0.5282,4259,17159
685,66751,36691,28603,0.4285,0.5496,-0.12109999999999999,-8088,17161
686,128082,68325,57150,0.4462,0.5334,-0.0872,-11175,17163
687,11067,2789,8103,0.7322,0.252,0.48019999999999996,5314,17165
688,104749,48917,53485,0.5106,0.467,0.04360000000000003,4568,17167
689,3918,1068,2773,0.7078,0.2726,0.4352,1705,17169
690,2743,572,2114,0.7707,0.2085,0.5622,1542,17171
691,12097,2504,9426,0.7792,0.207,0.5722,6922,17173
692,2886,815,2004,0.6944,0.2824,0.41200000000000003,1189,17175
693,22048,9055,12521,0.5679,0.4107,0.15719999999999995,3466,17177
694,69048,24819,42513,0.6157,0.3594,0.25630000000000003,17694,17179
695,8886,2579,6161,0.6933,0.2902,0.4031,3582,17181
696,31583,10323,20725,0.6562,0.3268,0.3294,10402,17183
697,5593,1253,4237,0.7576,0.224,0.5336000000000001,2984,17185
698,7924,3090,4676,0.5901,0.39,0.20009999999999994,1586,17187
699,7921,1641,6115,0.772,0.2072,0.5648,4474,17189
700,8486,1187,7176,0.8456,0.1399,0.7057,5989,17191
701,7421,1517,5791,0.7804,0.2044,0.576,4274,17193
702,27373,12253,14527,0.5307,0.4476,0.08309999999999995,2274,17195
703,345086,183915,155116,0.4495,0.5329,-0.08340000000000003,-28799,17197
704,33655,10206,22801,0.6775,0.3033,0.3742,12595,17199
705,127698,64056,60861,0.4766,0.5016,-0.025000000000000022,-3195,17201
706,21432,6160,14799,0.6905,0.2874,0.4031,8639,17203
707,14208,3236,10686,0.7521,0.2277,0.5244,7450,18001
708,169084,73189,92083,0.5446,0.4329,0.11169999999999997,18894,18003
709,36233,12934,22410,0.6185,0.3569,0.26160000000000005,9476,18005
710,4114,1009,3007,0.7309,0.2453,0.48560000000000003,1998,18007
711,5351,1376,3841,0.7178,0.2571,0.4607,2465,18009
712,38523,15244,22351,0.5802,0.3957,0.18450000000000005,7107,18011
713,8982,3036,5777,0.6432,0.338,0.30519999999999997,2741,18013
714,9495,2224,7086,0.7463,0.2342,0.5121,4862,18015
715,15198,4304,10552,0.6943,0.2832,0.4111,6248,18017
716,57869,23093,33668,0.5818,0.3991,0.18269999999999997,10575,18019
717,12266,2552,9499,0.7744,0.208,0.5664,6947,18021
718,12950,3361,9334,0.7208,0.2596,0.4612,5973,18023
719,4944,1355,3483,0.7045,0.2741,0.4304,2128,18025
720,11954,2169,9576,0.8011,0.1814,0.6197,7407,18027
721,25384,5446,19528,0.7693,0.2146,0.5547,14082,18029
722,12287,2439,9575,0.7793,0.1985,0.5808,7136,18031
723,19629,4966,14237,0.7253,0.253,0.47229999999999994,9271,18033
724,48189,20474,26827,0.5567,0.4249,0.13179999999999997,6353,18035
725,21771,6292,15033,0.6905,0.289,0.4015,8741,18037
726,74382,26108,46972,0.6315,0.351,0.28049999999999997,20864,18039
727,10136,2237,7755,0.7651,0.2207,0.5444,5518,18041
728,41801,17511,23400,0.5598,0.4189,0.14089999999999997,5889,18043
729,7986,1629,6154,0.7706,0.204,0.5666,4525,18045
730,12000,2137,9691,0.8076,0.1781,0.6295,7554,18047
731,9147,2280,6694,0.7318,0.2493,0.48250000000000004,4414,18049
732,16161,4023,11817,0.7312,0.2489,0.48229999999999995,7794,18051
733,27157,8015,18543,0.6828,0.2951,0.3877,10528,18053
734,14784,3389,11103,0.751,0.2292,0.5218,7714,18055
735,194016,88390,101587,0.5236,0.4556,0.06799999999999995,13197,18057
736,42913,12895,28996,0.6757,0.3005,0.3752,16101,18059
737,20235,5343,14565,0.7198,0.264,0.4558,9222,18061
738,88505,32604,53802,0.6079,0.3684,0.2395,21198,18063
739,21030,5544,15043,0.7153,0.2636,0.45170000000000005,9499,18065
740,40628,13303,26449,0.651,0.3274,0.3236,13146,18067
741,17829,4255,13147,0.7374,0.2387,0.49870000000000003,8892,18069
742,19237,4302,14555,0.7566,0.2236,0.533,10253,18071
743,15474,3798,11383,0.7356,0.2454,0.4902,7585,18073
744,8461,1926,6361,0.7518,0.2276,0.5242,4435,18075
745,14697,4731,9663,0.6575,0.3219,0.33559999999999995,4932,18077
746,12251,2523,9490,0.7746,0.2059,0.5687,6967,18079
747,77616,24736,51219,0.6599,0.3187,0.34120000000000006,26483,18081
748,16012,4067,11655,0.7279,0.254,0.4739,7588,18083
749,35785,8364,26499,0.7405,0.2337,0.5068,18135,18085
750,10633,2355,8110,0.7627,0.2215,0.5412,5755,18087
751,219942,124870,91760,0.4172,0.5677,-0.15049999999999997,-33110,18089
752,49396,22427,25997,0.5263,0.4541,0.07219999999999999,3570,18091
753,21026,4961,15601,0.742,0.236,0.506,10640,18093
754,51792,19524,31215,0.6027,0.377,0.2257,11691,18095
755,389591,247772,134175,0.3444,0.6359,-0.29150000000000004,-113597,18097
756,19928,5712,13844,0.6947,0.2866,0.40809999999999996,8132,18099
757,5144,1011,4029,0.7832,0.1965,0.5867,3018,18101
758,14472,3235,10925,0.7549,0.2235,0.5314,7690,18103
759,63150,39861,22071,0.3495,0.6312,-0.2817,-17790,18105
760,17197,4213,12659,0.7361,0.245,0.4911,8446,18107
761,36157,7781,27512,0.7609,0.2152,0.5457000000000001,19731,18109
762,6591,1509,4942,0.7498,0.2289,0.5209,3433,18111
763,19190,4660,14195,0.7397,0.2428,0.4969,9535,18113
764,3075,668,2054,0.668,0.2172,0.45080000000000003,1386,18115
765,8832,2224,6432,0.7283,0.2518,0.4764999999999999,4208,18117
766,9903,2420,7286,0.7357,0.2443,0.49140000000000006,4866,18119
767,7013,1503,5400,0.77,0.2143,0.5557000000000001,3897,18121
768,8722,3203,5345,0.6128,0.3672,0.24559999999999998,2142,18123
769,6220,1415,4692,0.7543,0.2275,0.5267999999999999,3277,18125
770,86504,39746,45008,0.5203,0.4594,0.06090000000000001,5262,18127
771,13237,3811,9206,0.6955,0.2879,0.4076,5395,18129
772,5806,1463,4246,0.7313,0.252,0.47929999999999995,2783,18131
773,16596,3946,12278,0.7398,0.2378,0.502,8332,18133
774,11069,2513,8312,0.7509,0.227,0.5239,5799,18135
775,14271,2774,11261,0.7891,0.1944,0.5947,8487,18137
776,7932,1754,6035,0.7608,0.2211,0.5397000000000001,4281,18139
777,115248,59896,53164,0.4613,0.5198,-0.05850000000000005,-6732,18141
778,10166,2701,7331,0.7211,0.2657,0.45539999999999997,4630,18143
779,19992,5023,14568,0.7287,0.2513,0.4774,9545,18145
780,10768,3213,7357,0.6832,0.2984,0.38480000000000003,4144,18147
781,10289,2650,7466,0.7256,0.2575,0.4681,4816,18149
782,16163,4513,11327,0.7008,0.2792,0.4216,6814,18151
783,8994,2153,6691,0.7439,0.2394,0.5045,4538,18153
784,4154,964,3133,0.7542,0.2321,0.5221,2169,18155
785,71448,35017,34581,0.484,0.4901,-0.006099999999999994,-436,18157
786,8116,1834,6110,0.7528,0.226,0.5268,4276,18159
787,3483,736,2688,0.7717,0.2113,0.5604,1952,18161
788,77661,34415,41844,0.5388,0.4431,0.09569999999999995,7429,18163
789,7481,2145,5184,0.693,0.2867,0.40629999999999994,3039,18165
790,43597,18123,24545,0.563,0.4157,0.14729999999999993,6422,18167
791,14573,3494,10762,0.7385,0.2398,0.49870000000000003,7268,18169
792,4472,974,3401,0.7605,0.2178,0.5427,2427,18171
793,33829,11923,21326,0.6304,0.3524,0.27799999999999997,9403,18173
794,12139,2784,9114,0.7508,0.2293,0.5215000000000001,6330,18175
795,27678,9524,17567,0.6347,0.3441,0.2906,8043,18177
796,14050,2928,10855,0.7726,0.2084,0.5641999999999999,7927,18179
797,11166,3032,7957,0.7126,0.2715,0.4411,4925,18181
798,17557,4234,12862,0.7326,0.2412,0.49140000000000006,8628,18183
799,4177,1198,2917,0.6983,0.2868,0.41150000000000003,1719,19001
800,2160,590,1530,0.7083,0.2731,0.43520000000000003,940,19003
801,7422,2576,4735,0.638,0.3471,0.2909,2159,19005
802,6516,1891,4512,0.6924,0.2902,0.4022,2621,19007
803,3420,1071,2295,0.6711,0.3132,0.35790000000000005,1224,19009
804,14642,5160,9188,0.6275,0.3524,0.27509999999999996,4028,19011
805,66592,35647,29640,0.4451,0.5353,-0.0902,-6007,19013
806,15341,6303,8695,0.5668,0.4109,0.15589999999999998,2392,19015
807,14546,5958,8294,0.5702,0.4096,0.16060000000000002,2336,19017
808,10774,4169,6420,0.5959,0.387,0.20889999999999997,2251,19019
809,8167,2961,5056,0.6191,0.3626,0.2565,2095,19021
810,8098,2424,5542,0.6844,0.2993,0.3851,3118,19023
811,5258,1470,3689,0.7016,0.2796,0.422,2219,19025
812,11335,3454,7737,0.6826,0.3047,0.37789999999999996,4283,19027
813,7276,2201,4969,0.6829,0.3025,0.38039999999999996,2768,19029
814,10704,4337,6161,0.5756,0.4052,0.1704,1824,19031
815,23799,10941,12442,0.5228,0.4597,0.06310000000000004,1501,19033
816,6518,1936,4495,0.6896,0.297,0.3926,2559,19035
817,6631,2233,4308,0.6497,0.3368,0.31290000000000007,2075,19037
818,4670,1466,3144,0.6732,0.3139,0.3593,1678,19039
819,8970,2662,6137,0.6842,0.2968,0.3874,3475,19041
820,9595,3340,6106,0.6364,0.3481,0.28829999999999995,2766,19043
821,24688,10812,13361,0.5412,0.438,0.10320000000000001,2549,19045
822,7154,2220,4854,0.6785,0.3103,0.36819999999999997,2634,19047
823,56019,26879,27987,0.4996,0.4798,0.019799999999999984,1108,19049
824,4102,1013,3032,0.7392,0.247,0.49219999999999997,2019,19051
825,3804,1120,2615,0.6874,0.2944,0.393,1495,19053
826,10003,3157,6666,0.6664,0.3156,0.3508,3509,19055
827,19955,8893,10592,0.5308,0.4456,0.08520000000000005,1699,19057
828,11244,3661,7438,0.6615,0.3256,0.3359,3777,19059
829,53921,25657,27214,0.5047,0.4758,0.028900000000000037,1557,19061
830,4853,1520,3265,0.6728,0.3132,0.3596,1745,19063
831,10186,3835,6145,0.6033,0.3765,0.22679999999999995,2310,19065
832,8033,3172,4732,0.5891,0.3949,0.19419999999999998,1560,19067
833,5130,1626,3422,0.6671,0.317,0.3501,1796,19069
834,3857,1080,2711,0.7029,0.28,0.42289999999999994,1631,19071
835,5057,1769,3223,0.6373,0.3498,0.2875,1454,19073
836,7276,2206,4929,0.6774,0.3032,0.3742,2723,19075
837,6371,1985,4272,0.6705,0.3116,0.3589,2287,19077
838,7944,2843,4956,0.6239,0.3579,0.266,2113,19079
839,6172,1683,4390,0.7113,0.2727,0.43860000000000005,2707,19081
840,8989,2976,5850,0.6508,0.3311,0.31970000000000004,2874,19083
841,8155,2440,5569,0.6829,0.2992,0.38369999999999993,3129,19085
842,9982,3275,6507,0.6519,0.3281,0.32380000000000003,3232,19087
843,4958,1772,3127,0.6307,0.3574,0.27330000000000004,1355,19089
844,5327,1442,3819,0.7169,0.2707,0.4462,2377,19091
845,3849,917,2880,0.7482,0.2382,0.51,1963,19093
846,9742,3547,6009,0.6168,0.3641,0.25270000000000004,2462,19095
847,11134,4029,6940,0.6233,0.3618,0.26149999999999995,2911,19097
848,20184,7737,12084,0.5987,0.3833,0.21540000000000004,4347,19099
849,8959,4319,4443,0.4959,0.4821,0.013800000000000034,124,19101
850,83851,59177,22925,0.2734,0.7057,-0.4323,-36252,19103
851,10988,4213,6572,0.5981,0.3834,0.21469999999999995,2359,19105
852,5303,1414,3797,0.716,0.2666,0.44939999999999997,2383,19107
853,9090,2696,6275,0.6903,0.2966,0.39370000000000005,3579,19109
854,16735,6541,9773,0.584,0.3909,0.19309999999999994,3232,19111
855,127452,70874,53364,0.4187,0.5561,-0.13740000000000002,-17510,19113
856,5332,1726,3500,0.6564,0.3237,0.3327,1774,19115
857,4630,1284,3287,0.7099,0.2773,0.4326,2003,19117
858,6863,1067,5707,0.8316,0.1555,0.6761,4640,19119
859,9823,3134,6507,0.6624,0.319,0.3434,3373,19121
860,11403,2894,8297,0.7276,0.2538,0.4738,5403,19123
861,19233,6178,12663,0.6584,0.3212,0.3372,6485,19125
862,18137,8176,9571,0.5277,0.4508,0.07689999999999997,1395,19127
863,8268,2508,5585,0.6755,0.3033,0.3722,3077,19129
864,5822,2053,3677,0.6316,0.3526,0.279,1624,19131
865,4728,1407,3248,0.687,0.2976,0.3894000000000001,1841,19133
866,4088,1078,2975,0.7277,0.2637,0.464,1897,19135
867,5327,1583,3659,0.6869,0.2972,0.38969999999999994,2076,19137
868,20670,9372,10823,0.5236,0.4534,0.07019999999999993,1451,19139
869,7551,1569,5861,0.7762,0.2078,0.5684,4292,19141
870,3328,601,2690,0.8083,0.1806,0.6277,2089,19143
871,7528,2086,5319,0.7066,0.2771,0.4295,3233,19145
872,4958,1519,3370,0.6797,0.3064,0.37329999999999997,1851,19147
873,14188,3494,10492,0.7395,0.2463,0.4932000000000001,6998,19149
874,3823,933,2826,0.7392,0.244,0.4952,1893,19151
875,258784,146250,106800,0.4127,0.5652,-0.15250000000000002,-39450,19153
876,45742,18575,26247,0.5738,0.4061,0.16769999999999996,7672,19155
877,10140,4306,5657,0.5579,0.4247,0.13319999999999993,1351,19157
878,2714,709,1968,0.7251,0.2612,0.4639,1259,19159
879,5535,1389,4061,0.7337,0.2509,0.4828,2672,19161
880,92608,46926,43683,0.4717,0.5068,-0.03510000000000002,-3243,19163
881,6795,1959,4697,0.6912,0.2883,0.40290000000000004,2738,19165
882,19050,3019,15680,0.8231,0.1585,0.6646000000000001,12661,19167
883,51041,29175,20340,0.3985,0.5716,-0.17309999999999998,-8835,19169
884,9048,3577,5303,0.5861,0.3953,0.19079999999999997,1726,19171
885,3249,746,2463,0.7581,0.2296,0.5285,1717,19173
886,6185,2061,4010,0.6483,0.3332,0.3151,1949,19175
887,3791,875,2859,0.7542,0.2308,0.5234,1984,19177
888,15633,5821,9516,0.6087,0.3724,0.2363,3695,19179
889,31039,12574,17782,0.5729,0.4051,0.16779999999999995,5208,19181
890,11765,4561,6971,0.5925,0.3877,0.20480000000000004,2410,19183
891,3109,727,2338,0.752,0.2338,0.5182,1611,19185
892,17823,6613,10938,0.6137,0.3711,0.24260000000000004,4325,19187
893,5970,2135,3707,0.6209,0.3576,0.26330000000000003,1572,19189
894,12065,5617,6235,0.5168,0.4656,0.05120000000000002,618,19191
895,45366,18704,25736,0.5673,0.4123,0.15500000000000003,7032,19193
896,4418,1596,2738,0.6197,0.3612,0.2585,1142,19195
897,6254,1996,4136,0.6613,0.3192,0.3421,2140,19197
898,5892,1570,4218,0.7159,0.2665,0.44939999999999997,2648,20001
899,3792,782,2929,0.7724,0.2062,0.5662,2147,20003
900,7440,2359,4906,0.6594,0.3171,0.3423,2547,20005
901,2342,291,2014,0.8599,0.1243,0.7356,1723,20007
902,11130,2340,8608,0.7734,0.2102,0.5631999999999999,6268,20009
903,6676,1541,5023,0.7524,0.2308,0.5216,3482,20011
904,4471,1104,3262,0.7296,0.2469,0.4827,2158,20013
905,32520,9181,22634,0.696,0.2823,0.41369999999999996,13453,20015
906,1491,345,1123,0.7532,0.2314,0.5218,778,20017
907,1639,212,1402,0.8554,0.1293,0.7261000000000001,1190,20019
908,9128,2194,6766,0.7412,0.2404,0.5007999999999999,4572,20021
909,1429,224,1183,0.8279,0.1568,0.6711,959,20023
910,1067,143,904,0.8472,0.134,0.7132,761,20025
911,4182,894,3177,0.7597,0.2138,0.5459,2283,20027
912,4263,920,3242,0.7605,0.2158,0.5447,2322,20029
913,4565,964,3489,0.7643,0.2112,0.5530999999999999,2525,20031
914,916,126,762,0.8319,0.1376,0.6942999999999999,636,20033
915,14231,4273,9656,0.6785,0.3003,0.3782,5383,20035
916,16645,6179,10045,0.6035,0.3712,0.23230000000000006,3866,20037
917,1498,218,1260,0.8411,0.1455,0.6956,1042,20039
918,9349,2060,7126,0.7622,0.2203,0.5419,5066,20041
919,3709,686,2976,0.8024,0.185,0.6174,2290,20043
920,59504,40785,17286,0.2905,0.6855,-0.395,-23499,20045
921,1431,271,1141,0.7973,0.1894,0.6079,870,20047
922,1361,195,1140,0.8376,0.1433,0.6943,945,20049
923,13800,3737,9758,0.7071,0.2708,0.43629999999999997,6021,20051
924,2853,648,2148,0.7529,0.2271,0.5258,1500,20053
925,11800,4325,7236,0.6132,0.3665,0.24669999999999997,2911,20055
926,8915,2947,5803,0.6509,0.3306,0.32030000000000003,2856,20057
927,12476,3690,8479,0.6796,0.2957,0.38389999999999996,4789,20059
928,9603,3983,5323,0.5543,0.4148,0.1395,1340,20061
929,1471,166,1291,0.8776,0.1128,0.7648,1125,20063
930,1337,228,1080,0.8078,0.1705,0.6373,852,20065
931,2501,518,1936,0.7741,0.2071,0.567,1418,20067
932,2288,341,1911,0.8352,0.149,0.6862,1570,20069
933,641,78,549,0.8565,0.1217,0.7348,471,20071
934,3077,569,2444,0.7943,0.1849,0.6093999999999999,1875,20073
935,859,141,698,0.8126,0.1641,0.6485,557,20075
936,2678,461,2168,0.8096,0.1721,0.6375,1707,20077
937,17310,6747,10182,0.5882,0.3898,0.19839999999999997,3435,20079
938,1410,268,1122,0.7957,0.1901,0.6055999999999999,854,20081
939,1045,154,875,0.8373,0.1474,0.6899000000000001,721,20083
940,6584,1881,4517,0.6861,0.2857,0.40040000000000003,2636,20085
941,9782,3194,6334,0.6475,0.3265,0.32099999999999995,3140,20087
942,1628,212,1387,0.852,0.1302,0.7218,1175,20089
943,347236,184259,155631,0.4482,0.5307,-0.08249999999999996,-28628,20091
944,1455,267,1164,0.8,0.1835,0.6165,897,20093
945,3949,752,3130,0.7926,0.1904,0.6022,2378,20095
946,1165,156,980,0.8412,0.1339,0.7072999999999999,824,20097
947,8564,2655,5735,0.6697,0.3101,0.3596,3080,20099
948,895,115,762,0.8514,0.1285,0.7229000000000001,647,20101
949,36491,13886,21610,0.5922,0.3805,0.21169999999999994,7724,20103
950,1579,266,1283,0.8125,0.1685,0.644,1017,20105
951,5046,896,4048,0.8022,0.1776,0.6246,3152,20107
952,1458,186,1249,0.8567,0.1276,0.7291000000000001,1063,20109
953,13989,6055,7550,0.5397,0.4329,0.10679999999999995,1495,20111
954,14438,4134,9964,0.6901,0.2863,0.40380000000000005,5830,20113
955,6111,1516,4465,0.7306,0.2481,0.48250000000000004,2949,20115
956,5114,1259,3729,0.7292,0.2462,0.483,2470,20117
957,1825,263,1523,0.8345,0.1441,0.6904,1260,20119
958,17936,5247,12308,0.6862,0.2925,0.39370000000000005,7061,20121
959,3101,558,2504,0.8075,0.1799,0.6275999999999999,1946,20123
960,13426,3228,9931,0.7397,0.2404,0.4993,6703,20125
961,2899,729,2124,0.7327,0.2515,0.4812,1395,20127
962,1198,150,1034,0.8631,0.1252,0.7379,884,20129
963,5684,927,4664,0.8205,0.1631,0.6574,3737,20131
964,6877,1796,4970,0.7227,0.2612,0.4615,3174,20133
965,1513,149,1339,0.885,0.0985,0.7865,1190,20135
966,2415,364,2007,0.8311,0.1507,0.6803999999999999,1643,20137
967,8035,2136,5705,0.71,0.2658,0.4442,3569,20139
968,1945,281,1629,0.8375,0.1445,0.6930000000000001,1348,20141
969,3191,506,2610,0.8179,0.1586,0.6593,2104,20143
970,2739,643,2045,0.7466,0.2348,0.5118,1402,20145
971,2781,318,2418,0.8695,0.1143,0.7552000000000001,2100,20147
972,13082,3313,9452,0.7225,0.2532,0.46930000000000005,6139,20149
973,4137,933,3108,0.7513,0.2255,0.5257999999999999,2175,20151
974,1504,214,1261,0.8384,0.1423,0.6961,1047,20153
975,27940,8886,18443,0.6601,0.318,0.3421,9557,20155
976,2657,424,2182,0.8212,0.1596,0.6616000000000001,1758,20157
977,4319,965,3262,0.7553,0.2234,0.5319,2297,20159
978,25173,12765,11610,0.4612,0.5071,-0.045899999999999996,-1155,20161
979,2699,339,2325,0.8614,0.1256,0.7358,1986,20163
980,1677,295,1350,0.805,0.1759,0.6291,1055,20165
981,3467,600,2790,0.8047,0.1731,0.6315999999999999,2190,20167
982,24531,8214,15722,0.6409,0.3348,0.30610000000000004,7508,20169
983,2354,299,2014,0.8556,0.127,0.7286,1715,20171
984,223673,95870,122416,0.5473,0.4286,0.11870000000000003,26546,20173
985,5294,1833,3372,0.6369,0.3462,0.2907,1539,20175
986,85648,43015,40443,0.4722,0.5022,-0.02999999999999997,-2572,20177
987,1445,147,1282,0.8872,0.1017,0.7855,1135,20179
988,2727,396,2269,0.832,0.1452,0.6868,1873,20181
989,2129,336,1763,0.8281,0.1578,0.6702999999999999,1427,20183
990,2034,357,1645,0.8088,0.1755,0.6333,1288,20185
991,776,148,614,0.7912,0.1907,0.6005,466,20187
992,2031,237,1760,0.8666,0.1167,0.7499,1523,20189
993,10928,2591,8105,0.7417,0.2371,0.5046,5514,20191
994,3810,625,3130,0.8215,0.164,0.6575,2505,20193
995,1630,242,1363,0.8362,0.1485,0.6877000000000001,1121,20195
996,3902,964,2845,0.7291,0.2471,0.482,1881,20197
997,825,44,770,0.9333,0.0533,0.88,726,20199
998,2883,475,2363,0.8196,0.1648,0.6548,1888,20201
999,968,149,808,0.8347,0.1539,0.6808,659,20203
1000,3954,723,3153,0.7974,0.1829,0.6145,2430,20205
1001,1546,294,1228,0.7943,0.1902,0.6041,934,20207
1002,56791,36788,18934,0.3334,0.6478,-0.31440000000000007,-17854,20209
1003,8768,1392,7276,0.8298,0.1588,0.671,5884,21001
1004,9364,1642,7587,0.8102,0.1754,0.6348,5945,21003
1005,13254,3348,9661,0.7289,0.2526,0.4763,6313,21005
1006,4225,825,3356,0.7943,0.1953,0.599,2531,21007
1007,20063,5127,14654,0.7304,0.2555,0.47490000000000004,9527,21009
1008,5627,1573,3986,0.7084,0.2795,0.4289,2413,21011
1009,10044,1789,8140,0.8104,0.1781,0.6323,6351,21013
1010,66997,20901,44814,0.6689,0.312,0.35690000000000005,23913,21015
1011,9648,3296,6190,0.6416,0.3416,0.29999999999999993,2894,21017
1012,21751,7083,14295,0.6572,0.3256,0.3316,7212,21019
1013,14478,5298,8872,0.6128,0.3659,0.2469,3574,21021
1014,4246,800,3398,0.8003,0.1884,0.6119,2598,21023
1015,5661,1301,4265,0.7534,0.2298,0.5236,2964,21025
1016,10201,2350,7701,0.7549,0.2304,0.5245,5351,21027
1017,41997,10552,30708,0.7312,0.2513,0.47989999999999994,20156,21029
1018,6125,1079,4960,0.8098,0.1762,0.6335999999999999,3881,21031
1019,6434,1433,4906,0.7625,0.2227,0.5398,3473,21033
1020,17457,5797,11352,0.6503,0.3321,0.3182,5555,21035
1021,48879,19374,28482,0.5827,0.3964,0.18630000000000002,9108,21037
1022,2638,463,2159,0.8184,0.1755,0.6429,1696,21039
1023,4136,1116,2954,0.7142,0.2698,0.44439999999999996,1838,21041
1024,11586,2642,8775,0.7574,0.228,0.5294,6133,21043
1025,7171,918,6179,0.8617,0.128,0.7337,5261,21045
1026,23865,8296,15080,0.6319,0.3477,0.2842,6784,21047
1027,18140,6004,11811,0.6511,0.331,0.3201,5807,21049
1028,7591,831,6677,0.8796,0.1095,0.7701,5846,21051
1029,4932,603,4280,0.8678,0.1223,0.7455,3677,21053
1030,4242,731,3451,0.8135,0.1723,0.6412,2720,21055
1031,3309,508,2769,0.8368,0.1535,0.6833,2261,21057
1032,49285,17286,31025,0.6295,0.3507,0.27879999999999994,13739,21059
1033,6132,1227,4828,0.7873,0.2001,0.5871999999999999,3601,21061
1034,2995,712,2246,0.7499,0.2377,0.5122,1534,21063
1035,6540,1355,5100,0.7798,0.2072,0.5726,3745,21065
1036,152923,90600,58860,0.3849,0.5925,-0.2076,-31740,21067
1037,7068,1474,5534,0.783,0.2085,0.5745,4060,21069
1038,16353,3884,12250,0.7491,0.2375,0.5116,8366,21071
1039,26071,12652,12900,0.4948,0.4853,0.009500000000000008,248,21073
1040,2426,794,1606,0.662,0.3273,0.33470000000000005,812,21075
1041,3849,822,2955,0.7677,0.2136,0.5541,2133,21077
1042,8706,1830,6754,0.7758,0.2102,0.5656000000000001,4924,21079
1043,11108,2205,8725,0.7855,0.1985,0.587,6520,21081
1044,17018,3560,13206,0.776,0.2092,0.5668,9646,21083
1045,11986,2400,9453,0.7887,0.2003,0.5883999999999999,7053,21085
1046,5812,920,4838,0.8324,0.1583,0.6741,3918,21087
1047,18175,4873,13064,0.7188,0.2681,0.4507,8191,21089
1048,4587,1351,3145,0.6856,0.2945,0.3911,1794,21091
1049,48937,18101,29832,0.6096,0.3699,0.23970000000000002,11731,21093
1050,10971,1494,9367,0.8538,0.1362,0.7176,7873,21095
1051,8859,2400,6334,0.715,0.2709,0.4441,3934,21097
1052,8370,1908,6345,0.7581,0.228,0.5301,4437,21099
1053,20696,7639,12730,0.6151,0.3691,0.246,5091,21101
1054,8110,2142,5843,0.7205,0.2641,0.45640000000000003,3701,21103
1055,2199,458,1714,0.7794,0.2083,0.5710999999999999,1256,21105
1056,21511,5439,15757,0.7325,0.2528,0.4797,10318,21107
1057,6113,605,5453,0.892,0.099,0.793,4848,21109
1058,386668,228358,150646,0.3896,0.5906,-0.201,-77712,21111
1059,26281,8567,17096,0.6505,0.326,0.32449999999999996,8529,21113
1060,10192,1608,8450,0.8291,0.1578,0.6713,6842,21115
1061,82202,32271,48129,0.5855,0.3926,0.19290000000000002,15858,21117
1062,6252,1412,4780,0.7646,0.2258,0.5388,3368,21119
1063,13272,2114,11012,0.8297,0.1593,0.6704,8898,21121
1064,7301,1504,5685,0.7787,0.206,0.5727,4181,21123
1065,28112,4475,23237,0.8266,0.1592,0.6674,18762,21125
1066,6955,1238,5633,0.8099,0.178,0.6318999999999999,4395,21127
1067,2801,481,2273,0.8115,0.1717,0.6398,1792,21129
1068,4813,446,4321,0.8978,0.0927,0.8051,3875,21131
1069,9135,1799,7226,0.791,0.1969,0.5941000000000001,5427,21133
1070,5883,823,4986,0.8475,0.1399,0.7076,4163,21135
1071,10914,2254,8489,0.7778,0.2065,0.5713,6235,21137
1072,5004,939,4010,0.8014,0.1876,0.6138,3071,21139
1073,12349,3094,9067,0.7342,0.2505,0.48369999999999996,5973,21141
1074,4228,1092,3100,0.7332,0.2583,0.4749,2008,21143
1075,33549,11195,21820,0.6504,0.3337,0.3167,10625,21145
1076,6438,725,5664,0.8798,0.1126,0.7672,4939,21147
1077,4782,1074,3633,0.7597,0.2246,0.5351,2559,21149
1078,43960,15581,27356,0.6223,0.3545,0.2678,11775,21151
1079,5447,1214,4174,0.7663,0.2229,0.5434,2960,21153
1080,8928,2722,6113,0.6847,0.3049,0.37979999999999997,3391,21155
1081,17603,4071,13297,0.7554,0.2313,0.5241,9226,21157
1082,3936,403,3496,0.8882,0.1024,0.7857999999999999,3093,21159
1083,7958,2362,5477,0.6882,0.2968,0.3914,3115,21161
1084,14113,3632,10185,0.7217,0.2574,0.4643,6553,21163
1085,3102,750,2311,0.745,0.2418,0.5032,1561,21165
1086,11736,3033,8506,0.7248,0.2585,0.4663,5473,21167
1087,5012,975,3959,0.7899,0.1945,0.5954,2984,21169
1088,5330,657,4628,0.8683,0.1233,0.745,3971,21171
1089,12842,3630,8993,0.7003,0.2827,0.4176,5363,21173
1090,5544,1175,4301,0.7758,0.2119,0.5639000000000001,3126,21175
1091,14235,3545,10497,0.7374,0.249,0.48840000000000006,6952,21177
1092,23257,7188,15703,0.6752,0.3091,0.36610000000000004,8515,21179
1093,3396,955,2408,0.7091,0.2812,0.42789999999999995,1453,21181
1094,11130,2404,8582,0.7711,0.216,0.5551,6178,21183
1095,37978,14505,22654,0.5965,0.382,0.21450000000000002,8149,21185
1096,5458,1098,4292,0.7864,0.2012,0.5851999999999999,3194,21187
1097,1896,216,1671,0.8813,0.1139,0.7674,1455,21189
1098,6925,1322,5515,0.7964,0.1909,0.6055,4193,21191
1099,10626,2356,8129,0.765,0.2217,0.5433,5773,21193
1100,25396,4866,20284,0.7987,0.1916,0.6071,15418,21195
1101,5505,1367,4041,0.7341,0.2483,0.4858,2674,21197
1102,31558,5666,25442,0.8062,0.1795,0.6267,19776,21199
1103,1146,253,884,0.7714,0.2208,0.5506,631,21201
1104,7784,1134,6577,0.8449,0.1457,0.6992,5443,21203
1105,10065,3880,5994,0.5955,0.3855,0.21000000000000002,2114,21205
1106,8955,1331,7519,0.8396,0.1486,0.6910000000000001,6188,21207
1107,28970,10567,17767,0.6133,0.3648,0.24849999999999994,7200,21209
1108,23549,8077,15055,0.6393,0.343,0.29629999999999995,6978,21211
1109,8732,2681,5888,0.6743,0.307,0.3673,3207,21213
1110,11433,2530,8737,0.7642,0.2213,0.5428999999999999,6207,21215
1111,12516,2963,9376,0.7491,0.2367,0.5124,6413,21217
1112,5363,1205,4062,0.7574,0.2247,0.5327,2857,21219
1113,7376,1791,5487,0.7439,0.2428,0.5011,3696,21221
1114,4320,1012,3227,0.747,0.2343,0.5126999999999999,2215,21223
1115,6577,1529,4965,0.7549,0.2325,0.5224,3436,21225
1116,55404,22479,31791,0.5738,0.4058,0.16799999999999998,9312,21227
1117,6225,1644,4482,0.72,0.2641,0.45589999999999997,2838,21229
1118,9240,1700,7430,0.8041,0.184,0.6201000000000001,5730,21231
1119,5993,1412,4506,0.7519,0.2356,0.5163,3094,21233
1120,15356,2552,12567,0.8184,0.1662,0.6522,10015,21235
1121,2979,839,2097,0.7039,0.2816,0.42229999999999995,1258,21237
1122,15212,6530,8362,0.5497,0.4293,0.12039999999999995,1832,21239
1123,28426,5443,22596,0.7949,0.1915,0.6034,17153,22001
1124,9810,2108,7574,0.7721,0.2149,0.5572,5466,22003
1125,62327,20399,40687,0.6528,0.3273,0.32550000000000007,20288,22005
1126,11235,3833,7271,0.6472,0.3412,0.306,3438,22007
1127,17292,4979,12028,0.6956,0.2879,0.4077,7049,22009
1128,16357,2542,13575,0.8299,0.1554,0.6745,11033,22011
1129,7050,3067,3891,0.5519,0.435,0.11689999999999995,824,22013
1130,54657,15662,38074,0.6966,0.2866,0.41,22412,22015
1131,104918,55110,48021,0.4577,0.5253,-0.0676,-7089,22017
1132,82657,25982,55066,0.6662,0.3143,0.3519,29084,22019
1133,4762,745,3976,0.8349,0.1564,0.6785,3231,22021
1134,4039,324,3671,0.9089,0.0802,0.8287,3347,22023
1135,4858,1269,3541,0.7289,0.2612,0.4677,2272,22025
1136,6581,2731,3770,0.5729,0.415,0.15789999999999998,1039,22027
1137,8828,3177,5550,0.6287,0.3599,0.26880000000000004,2373,22029
1138,14737,5457,9112,0.6183,0.3703,0.24799999999999994,3655,22031
1139,208194,115577,88420,0.4247,0.5552,-0.1305,-27157,22033
1140,3036,1900,1080,0.3557,0.6258,-0.2701,-820,22035
1141,10510,4280,6064,0.577,0.4073,0.16969999999999996,1784,22037
1142,15411,4158,11053,0.7172,0.2698,0.44739999999999996,6895,22039
1143,9720,2658,6970,0.7171,0.2735,0.44359999999999994,4312,22041
1144,9393,1157,8117,0.8642,0.1232,0.741,6960,22043
1145,32714,11027,21251,0.6496,0.3371,0.31249999999999994,10224,22045
1146,16719,8514,7893,0.4721,0.5092,-0.037099999999999966,-621,22047
1147,7632,2143,5394,0.7068,0.2808,0.426,3251,22049
1148,193726,84477,105949,0.5469,0.436,0.11090000000000005,21472,22051
1149,14841,3208,11423,0.7697,0.2162,0.5535000000000001,8215,22053
1150,114528,39685,72519,0.6332,0.3465,0.2867,32834,22055
1151,45387,8672,36024,0.7937,0.1911,0.6026,27352,22057
1152,7077,638,6378,0.9012,0.0902,0.8109999999999999,5740,22059
1153,19276,7559,11311,0.5868,0.3922,0.1946,3752,22061
1154,65229,9249,54877,0.8413,0.1418,0.6995,45628,22063
1155,4670,2654,1930,0.4133,0.5683,-0.15500000000000003,-724,22065
1156,11573,4946,6510,0.5625,0.4273,0.1352,1564,22067
1157,16554,6896,9358,0.5653,0.4166,0.1487,2462,22069
1158,177760,147854,26664,0.15,0.8315,-0.6815,-121190,22071
1159,69168,25913,42255,0.6109,0.3746,0.2363,16342,22073
1160,11013,3414,7412,0.673,0.31,0.36300000000000004,3998,22075
1161,12371,4683,7503,0.6065,0.3785,0.22800000000000004,2820,22077
1162,58869,19475,38347,0.6514,0.3308,0.3206,18872,22079
1163,4132,1644,2413,0.584,0.3979,0.1861,769,22081
1164,9940,3225,6607,0.6647,0.3244,0.34029999999999994,3382,22083
1165,10596,1731,8776,0.8282,0.1634,0.6648000000000001,7045,22085
1166,17649,6151,11179,0.6334,0.3485,0.2849,5028,22087
1167,28516,9800,18233,0.6394,0.3437,0.29569999999999996,8433,22089
1168,6158,3346,2714,0.4407,0.5434,-0.10270000000000001,-632,22091
1169,12590,6510,5954,0.4729,0.5171,-0.04420000000000002,-556,22093
1170,21433,13582,7538,0.3517,0.6337,-0.28200000000000003,-6044,22095
1171,41156,17372,23171,0.563,0.4221,0.14089999999999997,5799,22097
1172,27040,8439,18203,0.6732,0.3121,0.36110000000000003,9764,22099
1173,23186,8055,14811,0.6388,0.3474,0.29140000000000005,6756,22101
1174,140118,37746,99666,0.7113,0.2694,0.44190000000000007,61920,22103
1175,57657,18887,37806,0.6557,0.3276,0.32809999999999995,18919,22105
1176,2554,1329,1197,0.4687,0.5204,-0.05169999999999997,-132,22107
1177,46242,11198,34339,0.7426,0.2422,0.5004000000000001,23141,22109
1178,11200,2654,8407,0.7506,0.2369,0.5137,5753,22111
1179,27324,5009,21930,0.8026,0.1833,0.6193,16921,22113
1180,17269,2898,14107,0.8169,0.1678,0.6491,11209,22115
1181,19512,5970,13307,0.682,0.3059,0.37610000000000005,7337,22117
1182,18217,6172,11830,0.6494,0.3388,0.3106,5658,22119
1183,14096,6200,7684,0.5451,0.4398,0.1053,1484,22121
1184,5052,710,4317,0.8545,0.1405,0.714,3607,22123
1185,6268,2298,3863,0.6163,0.3666,0.24969999999999998,1565,22125
1186,6225,1543,4619,0.742,0.2479,0.4941,3076,22127
1187,58712,27617,29268,0.4985,0.4704,0.028100000000000014,1651,23001
1188,35747,13956,21080,0.5897,0.3904,0.19929999999999998,7124,23003
1189,193769,128759,59584,0.3075,0.6645,-0.357,-69175,23005
1190,17390,8069,8754,0.5034,0.464,0.039399999999999935,685,23007
1191,35327,19369,14982,0.4241,0.5483,-0.12420000000000003,-4387,23009
1192,71856,34902,34721,0.4832,0.4857,-0.0025000000000000022,-181,23011
1193,25733,15110,9982,0.3879,0.5872,-0.19930000000000003,-5128,23013
1194,23593,12684,10256,0.4347,0.5376,-0.10289999999999999,-2428,23015
1195,33494,14755,17698,0.5284,0.4406,0.08779999999999999,2943,23017
1196,85267,37713,44825,0.5257,0.4423,0.08339999999999992,7112,23019
1197,9908,3517,6143,0.62,0.355,0.265,2626,23021
1198,24039,13528,9755,0.4058,0.5628,-0.15699999999999997,-3773,23023
1199,27579,10199,16644,0.6035,0.3698,0.23370000000000002,6445,23025
1200,24323,12345,11196,0.4603,0.5076,-0.047300000000000064,-1149,23027
1201,17357,6761,10194,0.5873,0.3895,0.19780000000000003,3433,23029
1202,129652,71189,54817,0.4228,0.549,-0.12620000000000003,-16372,23031
1203,30643,9158,20886,0.6816,0.2989,0.3827,11728,24001
1204,309644,172823,127821,0.4128,0.5582,-0.14540000000000003,-45002,24003
1205,414875,258409,146202,0.3524,0.6228,-0.27040000000000003,-112207,24005
1206,49111,22587,25346,0.5161,0.4599,0.05620000000000003,2759,24009
1207,15793,5095,10283,0.6511,0.3226,0.3285,5188,24011
1208,100330,36456,60218,0.6002,0.3634,0.23679999999999995,23762,24013
1209,47459,16809,29439,0.6203,0.3542,0.26609999999999995,12630,24015
1210,89500,62171,25579,0.2858,0.6947,-0.4089,-36592,24017
1211,15978,6857,8764,0.5485,0.4292,0.11929999999999996,1907,24019
1212,145625,77675,63682,0.4373,0.5334,-0.09609999999999996,-13993,24021
1213,15611,3281,12002,0.7688,0.2102,0.5586,8721,24023
1214,148196,63095,80930,0.5461,0.4258,0.12030000000000002,17835,24025
1215,183087,129433,48390,0.2643,0.707,-0.4427,-81043,24027
1216,10794,5329,5195,0.4813,0.4937,-0.012400000000000022,-134,24029
1217,533871,419569,101222,0.1896,0.7861,-0.5965,-318347,24031
1218,424857,379208,37090,0.0873,0.8926,-0.8052999999999999,-342118,24033
1219,30291,10709,18741,0.6187,0.3535,0.26520000000000005,8032,24035
1220,55663,23138,30826,0.5538,0.4157,0.13809999999999995,7688,24037
1221,10147,4241,5739,0.5656,0.418,0.1476,1498,24039
1222,22555,11062,10946,0.4853,0.4904,-0.005099999999999993,-116,24041
1223,67774,26044,40224,0.5935,0.3842,0.20930000000000004,14180,24043
1224,46211,22054,22944,0.4965,0.4772,0.019299999999999984,890,24045
1225,31691,12560,18571,0.586,0.3963,0.18969999999999998,6011,24047
1226,237362,207260,25374,0.1069,0.8728,-0.7659,-181886,24510
1227,150342,91994,55311,0.3679,0.612,-0.24409999999999998,-36683,25001
1228,71371,51705,18064,0.2531,0.7244,-0.47130000000000005,-33641,25003
1229,279292,153377,119872,0.4292,0.5492,-0.12,-33505,25005
1230,12797,9914,2631,0.2056,0.7747,-0.5691,-7283,25007
1231,421160,267198,144837,0.3439,0.6344,-0.2905,-122361,25009
1232,42460,30030,11201,0.2638,0.7073,-0.44350000000000006,-18829,25011
1233,218186,125948,87318,0.4002,0.5773,-0.17710000000000004,-38630,25013
1234,87859,63362,22281,0.2536,0.7212,-0.46759999999999996,-41081,25015
1235,863607,617196,226956,0.2628,0.7147,-0.4519,-390240,25017
1236,7305,5241,1914,0.262,0.7174,-0.4554,-3327,25019
1237,407725,273312,125294,0.3073,0.6703,-0.363,-148018,25021
1238,301785,173630,121227,0.4017,0.5753,-0.17360000000000003,-52403,25023
1239,335507,270522,58613,0.1747,0.8064,-0.6317,-211909,25025
1240,432016,248773,171683,0.3974,0.5758,-0.1784,-77090,25027
1241,7064,2142,4848,0.6863,0.3032,0.3831,2706,26001
1242,5135,2053,3014,0.587,0.3998,0.18719999999999998,961,26003
1243,67195,24449,41392,0.616,0.3639,0.2521,16943,26005
1244,16986,6000,10686,0.6291,0.3532,0.2759,4686,26007
1245,15972,5960,9748,0.6103,0.3732,0.23709999999999998,3788,26009
1246,8839,2774,5928,0.6707,0.3138,0.35689999999999994,3154,26011
1247,4047,1478,2512,0.6207,0.3652,0.2555,1034,26013
1248,35960,11797,23471,0.6527,0.328,0.32469999999999993,11674,26015
1249,60260,26151,33125,0.5497,0.434,0.11569999999999997,6974,26017
1250,12263,5480,6601,0.5383,0.4469,0.09139999999999998,1121,26019
1251,82563,37438,43519,0.5271,0.4534,0.07369999999999999,6081,26021
1252,20573,6159,14064,0.6836,0.2994,0.3842,7905,26023
1253,66278,28877,36221,0.5465,0.4357,0.11080000000000001,7344,26025
1254,26244,9130,16699,0.6363,0.3479,0.2884,7569,26027
1255,17029,6939,9841,0.5779,0.4075,0.1704,2902,26029
1256,15891,5437,10186,0.641,0.3422,0.2988,4749,26031
1257,17672,6648,10681,0.6044,0.3762,0.22820000000000007,4033,26033
1258,16296,5199,10861,0.6665,0.3191,0.3474,5662,26035
1259,47924,21968,25098,0.5237,0.4584,0.06530000000000008,3130,26037
1260,7861,2672,5087,0.6471,0.3399,0.30720000000000003,2415,26039
1261,21168,7606,13207,0.6239,0.3593,0.2646,5601,26041
1262,14616,4744,9617,0.658,0.3246,0.33340000000000003,4873,26043
1263,64329,31299,31798,0.4943,0.4866,0.00770000000000004,499,26045
1264,22209,9662,12135,0.5464,0.435,0.1114,2473,26047
1265,221779,119390,98714,0.4451,0.5384,-0.0933,-20676,26049
1266,14615,4524,9893,0.6769,0.3095,0.36739999999999995,5369,26051
1267,8276,3570,4600,0.5558,0.4314,0.12439999999999996,1030,26053
1268,60352,28683,30502,0.5054,0.4753,0.03009999999999996,1819,26055
1269,19149,6693,12102,0.632,0.3495,0.28250000000000003,5409,26057
1270,23303,5883,17037,0.7311,0.2525,0.47859999999999997,11154,26059
1271,18532,7750,10378,0.56,0.4182,0.14180000000000004,2628,26061
1272,18443,5490,12731,0.6903,0.2977,0.3926,7241,26063
1273,144536,94212,47639,0.3296,0.6518,-0.32220000000000004,-46573,26065
1274,32211,10901,20657,0.6413,0.3384,0.3029,9756,26067
1275,15388,5373,9759,0.6342,0.3492,0.285,4386,26069
1276,6795,2493,4216,0.6205,0.3669,0.25360000000000005,1723,26071
1277,29477,14072,14815,0.5026,0.4774,0.025200000000000056,743,26073
1278,81019,31995,47372,0.5847,0.3949,0.18980000000000002,15377,26075
1279,143747,83686,56823,0.3953,0.5822,-0.18690000000000007,-26863,26077
1280,10630,3002,7436,0.6995,0.2824,0.4171,4434,26079
1281,362038,187915,165741,0.4578,0.5191,-0.06130000000000002,-22174,26081
1282,1557,672,862,0.5536,0.4316,0.122,190,26083
1283,6332,2288,3946,0.6232,0.3613,0.26189999999999997,1658,26085
1284,52730,16367,35482,0.6729,0.3104,0.36250000000000004,19115,26087
1285,16900,8795,7916,0.4684,0.5204,-0.05199999999999999,-879,26089
1286,53450,20918,31541,0.5901,0.3913,0.19879999999999998,10623,26091
1287,127201,48220,76982,0.6052,0.3791,0.22609999999999997,28762,26093
1288,3007,842,2109,0.7014,0.28,0.4214,1267,26095
1289,7025,2632,4304,0.6127,0.3747,0.23800000000000004,1672,26097
1290,494218,223952,263863,0.5339,0.4531,0.08080000000000004,39911,26099
1291,14655,6107,8321,0.5678,0.4167,0.15109999999999996,2214,26101
1292,37551,20465,16286,0.4337,0.545,-0.11130000000000007,-4179,26103
1293,17282,6802,10207,0.5906,0.3936,0.197,3405,26105
1294,21082,7375,13267,0.6293,0.3498,0.27949999999999997,5892,26107
1295,12622,4316,8117,0.6431,0.342,0.3011,3801,26109
1296,49174,20493,27675,0.5628,0.4167,0.14609999999999995,7182,26111
1297,8755,1967,6648,0.7593,0.2247,0.5346,4681,26113
1298,87283,32975,52710,0.6039,0.3778,0.22609999999999997,19735,26115
1299,32138,9703,21815,0.6788,0.3019,0.37689999999999996,12112,26117
1300,5863,1628,4171,0.7114,0.2777,0.43370000000000003,2543,26119
1301,92448,45643,45133,0.4882,0.4937,-0.005500000000000005,-510,26121
1302,27199,7873,18857,0.6933,0.2895,0.40380000000000005,10984,26123
1303,772077,434148,325971,0.4222,0.5624,-0.1402,-108177,26125
1304,14081,4944,8892,0.6315,0.3511,0.2803999999999999,3948,26127
1305,11907,3475,8253,0.6931,0.2918,0.40130000000000005,4778,26129
1306,3810,1391,2358,0.6189,0.3651,0.2538,967,26131
1307,12340,3214,8928,0.7235,0.2605,0.463,5714,26133
1308,4880,1342,3466,0.7102,0.275,0.43520000000000003,2124,26135
1309,14774,4743,9779,0.6619,0.321,0.34090000000000004,5036,26137
1310,168723,64705,100913,0.5981,0.3835,0.21459999999999996,36208,26139
1311,8355,2911,5342,0.6394,0.3484,0.291,2431,26141
1312,15034,5166,9670,0.6432,0.3436,0.2996,4504,26143
1313,103474,51088,50785,0.4908,0.4937,-0.0029000000000000137,-303,26145
1314,92203,31363,59185,0.6419,0.3402,0.3017,27822,26147
1315,27982,9262,18127,0.6478,0.331,0.3168,8865,26149
1316,22445,5966,16194,0.7215,0.2658,0.45570000000000005,10228,26151
1317,4745,1589,3090,0.6512,0.3349,0.3163,1501,26153
1318,39302,15347,23149,0.589,0.3905,0.19849999999999995,7802,26155
1319,29480,8712,20297,0.6885,0.2955,0.393,11585,26157
1320,39142,16803,21591,0.5516,0.4292,0.12239999999999995,4788,26159
1321,216895,157136,56241,0.2593,0.7244,-0.46510000000000007,-100895,26161
1322,873978,597170,264553,0.3027,0.6832,-0.3805,-332617,26163
1323,18292,5838,12102,0.6616,0.3192,0.3424,6264,26165
1324,10026,3607,6258,0.6242,0.3598,0.26439999999999997,2651,27001
1325,211113,100890,104902,0.4969,0.4778,0.019100000000000006,4012,27003
1326,19401,6589,12438,0.6411,0.3396,0.3015,5849,27005
1327,24192,11426,12188,0.5038,0.4723,0.03150000000000003,762,27007
1328,22260,7281,14382,0.6461,0.3271,0.319,7101,27009
1329,2973,1053,1862,0.6263,0.3542,0.27209999999999995,809,27011
1330,36050,18330,16731,0.4641,0.5084,-0.04429999999999995,-1599,27013
1331,14635,4753,9552,0.6527,0.3248,0.32789999999999997,4799,27015
1332,20368,10098,9791,0.4807,0.4958,-0.015100000000000002,-307,27017
1333,66359,30773,34009,0.5125,0.4637,0.048799999999999955,3236,27019
1334,18289,6342,11621,0.6354,0.3467,0.28869999999999996,5279,27021
1335,6611,2226,4250,0.6429,0.3367,0.3062,2024,27023
1336,34566,11801,21915,0.634,0.3414,0.2926,10114,27025
1337,32240,16357,15043,0.4666,0.5074,-0.04079999999999995,-1314,27027
1338,4708,1260,3372,0.7162,0.2676,0.44859999999999994,2112,27029
1339,3808,2496,1203,0.3159,0.6555,-0.33959999999999996,-1293,27031
1340,6107,1834,4165,0.682,0.3003,0.38170000000000004,2331,27033
1341,40175,13726,25676,0.6391,0.3417,0.2974,11950,27035
1342,262287,146153,109636,0.418,0.5573,-0.13930000000000003,-36517,27037
1343,12184,4078,7782,0.6387,0.3347,0.30400000000000005,3704,27039
1344,24165,7868,15799,0.6538,0.3256,0.32820000000000005,7931,27041
1345,7914,2531,5191,0.6559,0.3198,0.33610000000000007,2660,27043
1346,12142,4551,7301,0.6013,0.3748,0.22649999999999992,2750,27045
1347,16818,6889,9578,0.5695,0.4096,0.1599,2689,27047
1348,28634,11805,16052,0.5606,0.4123,0.1483,4247,27049
1349,3654,1300,2269,0.621,0.3558,0.2652,969,27051
1350,755839,532608,205966,0.2725,0.7045,-0.432,-326642,27053
1351,11439,4853,6334,0.5537,0.4242,0.12949999999999995,1481,27055
1352,12966,4462,8202,0.6326,0.3441,0.28850000000000003,3740,27057
1353,24237,7138,16491,0.6804,0.2945,0.3859,9353,27059
1354,26563,10787,15239,0.5737,0.4061,0.16759999999999997,4452,27061
1355,5819,1745,3948,0.6785,0.2999,0.3786,2203,27063
1356,9242,2774,6278,0.6793,0.3002,0.3791,3504,27065
1357,23368,8440,14437,0.6178,0.3612,0.2566,5997,27067
1358,2639,1006,1546,0.5858,0.3812,0.2046,540,27069
1359,6922,2659,4131,0.5968,0.3841,0.2127,1472,27071
1360,4039,1445,2528,0.6259,0.3578,0.2681,1083,27073
1361,7202,3647,3393,0.4711,0.5064,-0.03529999999999994,-254,27075
1362,2408,671,1704,0.7076,0.2787,0.4289,1033,27077
1363,16818,5671,10775,0.6407,0.3372,0.30350000000000005,5104,27079
1364,3115,937,2121,0.6809,0.3008,0.38009999999999994,1184,27081
1365,12888,4630,7979,0.6191,0.3592,0.25989999999999996,3349,27083
1366,20934,6413,13986,0.6681,0.3063,0.3618,7573,27085
1367,2304,1112,1142,0.4957,0.4826,0.0131,30,27087
1368,5113,1295,3721,0.7278,0.2533,0.4745,2426,27089
1369,11010,3305,7480,0.6794,0.3002,0.3792,4175,27091
1370,13527,3867,9358,0.6918,0.2859,0.4059,5491,27093
1371,14691,4403,9953,0.6775,0.2997,0.37779999999999997,5550,27095
1372,19555,4367,14819,0.7578,0.2233,0.5345,10452,27097
1373,19346,8899,10025,0.5182,0.46,0.058199999999999974,1126,27099
1374,4896,1449,3363,0.6869,0.296,0.39089999999999997,1914,27101
1375,19122,9622,9018,0.4716,0.5031,-0.03149999999999997,-604,27103
1376,8715,2933,5600,0.6426,0.3365,0.3060999999999999,2667,27105
1377,3442,1404,1954,0.5677,0.4079,0.1598,550,27107
1378,91393,49492,39692,0.4343,0.5416,-0.10729999999999995,-9800,27109
1379,36403,11958,23800,0.6538,0.3285,0.32530000000000003,11842,27111
1380,7279,2568,4532,0.6226,0.3528,0.26980000000000004,1964,27113
1381,16000,5419,10256,0.641,0.3387,0.3023,4837,27115
1382,4941,1306,3553,0.7191,0.2643,0.4548,2247,27117
1383,15593,5439,9864,0.6326,0.3488,0.28380000000000005,4425,27119
1384,7022,2477,4417,0.629,0.3527,0.2763,1940,27121
1385,296025,211628,77381,0.2614,0.715,-0.45359999999999995,-134247,27123
1386,2196,691,1454,0.6621,0.3147,0.34740000000000004,763,27125
1387,8285,2355,5771,0.6966,0.2843,0.4123,3416,27127
1388,8127,2496,5466,0.6726,0.3071,0.3655,2970,27129
1389,35690,17402,17463,0.4893,0.4876,0.0017000000000000348,61,27131
1390,5240,1556,3582,0.6836,0.2969,0.3867,2026,27133
1391,8421,2188,6065,0.7202,0.2598,0.4604,3877,27135
1392,119551,67708,49016,0.41,0.5664,-0.15640000000000004,-18692,27137
1393,87960,40037,45871,0.5215,0.4552,0.06629999999999997,5834,27139
1394,55613,18064,36221,0.6513,0.3248,0.3265,18157,27141
1395,8452,2417,5864,0.6938,0.286,0.4078,3447,27143
1396,84847,31881,50959,0.6006,0.3758,0.2248,19078,27145
1397,21129,7917,12656,0.599,0.3747,0.2243,4739,27147
1398,5085,1921,3044,0.5986,0.3778,0.2208,1123,27149
1399,5193,1784,3316,0.6386,0.3435,0.2950999999999999,1532,27151
1400,13257,3286,9753,0.7357,0.2479,0.4878,6467,27153
1401,1864,661,1172,0.6288,0.3546,0.2742,511,27155
1402,13122,4696,8153,0.6213,0.3578,0.26349999999999996,3457,27157
1403,7677,2023,5520,0.719,0.2635,0.45549999999999996,3497,27159
1404,10389,3496,6624,0.6376,0.3365,0.3010999999999999,3128,27161
1405,166774,89164,73764,0.4423,0.5346,-0.09229999999999994,-15400,27163
1406,5201,1987,3103,0.5966,0.382,0.2146,1116,27165
1407,3430,1026,2328,0.6787,0.2991,0.3796,1302,27167
1408,27171,13333,13227,0.4868,0.4907,-0.0039000000000000146,-106,27169
1409,82427,28427,51970,0.6305,0.3449,0.28559999999999997,23543,27171
1410,5527,1687,3734,0.6756,0.3052,0.37039999999999995,2047,27173
1411,13758,7917,5696,0.414,0.5754,-0.16140000000000004,-2221,28001
1412,15793,2782,12818,0.8116,0.1762,0.6354,10036,28003
1413,7196,2620,4503,0.6258,0.3641,0.26170000000000004,1883,28005
1414,8823,3542,5178,0.5869,0.4015,0.18539999999999995,1636,28007
1415,4289,1679,2570,0.5992,0.3915,0.20769999999999994,891,28009
1416,13742,8904,4671,0.3399,0.6478,-0.30790000000000006,-4233,28011
1417,6590,1902,4625,0.7018,0.2886,0.41319999999999996,2723,28013
1418,5701,1729,3924,0.6883,0.3033,0.385,2195,28015
1419,8142,3810,4175,0.5128,0.468,0.044800000000000006,365,28017
1420,4223,1185,3001,0.7106,0.2806,0.43,1816,28019
1421,4450,3772,603,0.1355,0.8478,-0.7122999999999999,-3169,28021
1422,8338,2838,5417,0.6497,0.3404,0.3093000000000001,2579,28023
1423,10190,5844,4181,0.4103,0.5736,-0.1633,-1663,28025
1424,8636,6130,2400,0.2779,0.7098,-0.4319,-3730,28027
1425,12884,6470,6250,0.4851,0.5022,-0.017100000000000004,-220,28029
1426,9360,3416,5854,0.6254,0.365,0.26039999999999996,2438,28031
1427,76130,28265,46462,0.6103,0.3713,0.23899999999999993,18197,28033
1428,31655,13755,17290,0.5462,0.4345,0.11170000000000002,3535,28035
1429,4461,1480,2923,0.6552,0.3318,0.3234,1443,28037
1430,11049,1218,9713,0.8791,0.1102,0.7689,8495,28039
1431,5812,966,4794,0.8248,0.1662,0.6586,3828,28041
1432,10912,4734,6081,0.5573,0.4339,0.12340000000000001,1347,28043
1433,20956,4504,16132,0.7698,0.2149,0.5549000000000001,11628,28045
1434,75764,27728,46822,0.618,0.366,0.252,19094,28047
1435,100004,73550,25141,0.2514,0.7355,-0.48410000000000003,-48409,28049
1436,8115,6588,1369,0.1687,0.8118,-0.6431,-5219,28051
1437,4189,3016,1118,0.2669,0.72,-0.45309999999999995,-1898,28053
1438,676,355,308,0.4556,0.5251,-0.0695,-47,28055
1439,10818,1249,9438,0.8724,0.1154,0.7569999999999999,8189,28057
1440,54546,17375,36295,0.6654,0.3186,0.3468,18920,28059
1441,8737,4341,4302,0.4924,0.4969,-0.004500000000000004,-39,28061
1442,3907,3327,531,0.1359,0.8513,-0.7153999999999999,-2796,28063
1443,6212,3599,2534,0.4079,0.5793,-0.17140000000000005,-1065,28065
1444,30091,8517,21226,0.7054,0.283,0.42240000000000005,12709,28067
1445,4731,2887,1787,0.3777,0.6102,-0.23249999999999998,-1100,28069
1446,23424,10070,12949,0.5528,0.4299,0.12289999999999995,2879,28071
1447,28487,7340,20704,0.7268,0.2577,0.4691,13364,28073
1448,31247,12960,17967,0.575,0.4148,0.16019999999999995,5007,28075
1449,6613,2260,4285,0.648,0.3418,0.3062,2025,28077
1450,9199,3897,5228,0.5683,0.4236,0.14470000000000005,1331,28079
1451,36952,12189,24207,0.6551,0.3298,0.32530000000000003,12018,28081
1452,10895,7648,3129,0.2872,0.7021,-0.41489999999999994,-4519,28083
1453,16801,5040,11596,0.6902,0.3,0.39020000000000005,6556,28085
1454,27240,13087,13800,0.5066,0.4804,0.026200000000000057,713,28087
1455,56212,24440,31091,0.5531,0.4348,0.11830000000000002,6651,28089
1456,12177,3787,8273,0.6794,0.311,0.3684,4486,28091
1457,15819,8057,7566,0.4783,0.5094,-0.03109999999999996,-491,28093
1458,17259,5874,11177,0.6476,0.3403,0.30729999999999996,5303,28095
1459,5075,2121,2917,0.5748,0.4179,0.15689999999999998,796,28097
1460,11703,3260,8320,0.7109,0.2786,0.43229999999999996,5060,28099
1461,10183,3075,6997,0.6871,0.302,0.38510000000000005,3922,28101
1462,5338,4040,1240,0.2323,0.7567,-0.5244,-2800,28103
1463,19759,10299,9004,0.4557,0.5213,-0.06559999999999999,-1295,28105
1464,15626,7403,8060,0.5158,0.4737,0.042100000000000026,657,28107
1465,24034,4148,19595,0.8153,0.1726,0.6427,15447,28109
1466,5916,1362,4500,0.7606,0.2302,0.5304000000000001,3138,28111
1467,17343,8646,8479,0.4889,0.4986,-0.009699999999999986,-167,28113
1468,14360,2614,11550,0.8043,0.182,0.6223000000000001,8936,28115
1469,10571,2139,8312,0.7863,0.2023,0.584,6173,28117
1470,3226,2150,1026,0.318,0.6665,-0.3485,-1124,28119
1471,70658,18847,50895,0.7203,0.2667,0.45360000000000006,32048,28121
1472,10733,4330,6285,0.5856,0.4034,0.18220000000000003,1955,28123
1473,2183,1465,688,0.3152,0.6711,-0.35590000000000005,-777,28125
1474,11815,4037,7635,0.6462,0.3417,0.3045,3598,28127
1475,8328,1791,6458,0.7755,0.2151,0.5604,4667,28129
1476,7878,1802,5964,0.757,0.2287,0.5283,4162,28131
1477,9682,6781,2799,0.2891,0.7004,-0.4113,-3982,28133
1478,5686,3105,2488,0.4376,0.5462,-0.10860000000000003,-617,28135
1479,13093,4183,8707,0.665,0.3195,0.34550000000000003,4524,28137
1480,10102,1937,8054,0.7973,0.1917,0.6056,6117,28139
1481,9138,1059,7933,0.8681,0.1159,0.7522,6874,28141
1482,3562,2580,926,0.26,0.7243,-0.46430000000000005,-1654,28143
1483,12682,2160,10373,0.8179,0.1703,0.6476,8213,28145
1484,7119,2835,4220,0.5928,0.3982,0.1946,1385,28147
1485,21054,10442,10365,0.4923,0.496,-0.003699999999999981,-77,28149
1486,18009,12503,5300,0.2943,0.6943,-0.4,-7203,28151
1487,10056,3624,6307,0.6272,0.3604,0.2668,2683,28153
1488,5395,1043,4291,0.7954,0.1933,0.6021,3248,28155
1489,4127,2749,1324,0.3208,0.6661,-0.34530000000000005,-1425,28157
1490,9236,4040,5112,0.5535,0.4374,0.11609999999999998,1072,28159
1491,6536,2785,3671,0.5617,0.4262,0.13549999999999995,886,28161
1492,10436,5496,4832,0.463,0.5266,-0.06359999999999993,-664,28163
1493,10335,3710,6413,0.6205,0.3589,0.26160000000000005,2703,29001
1494,9753,2351,7255,0.7439,0.2411,0.5028,4904,29003
1495,2814,564,2199,0.7814,0.2004,0.581,1635,29005
1496,10656,2704,7732,0.7256,0.2538,0.4718,5028,29007
1497,15598,2948,12425,0.7966,0.189,0.6075999999999999,9477,29009
1498,6077,844,5168,0.8504,0.1389,0.7115,4324,29011
1499,8416,1672,6597,0.7839,0.1987,0.5852,4925,29013
1500,10475,2180,8109,0.7741,0.2081,0.5660000000000001,5929,29015
1501,5983,750,5167,0.8636,0.1254,0.7382,4417,29017
1502,91168,50064,38646,0.4239,0.5491,-0.12520000000000003,-11418,29019
1503,36599,13445,22450,0.6134,0.3674,0.24599999999999994,9005,29021
1504,18141,3301,14602,0.8049,0.182,0.6229,11301,29023
1505,4682,897,3725,0.7956,0.1916,0.604,2828,29025
1506,21143,5870,14815,0.7007,0.2776,0.4231,8945,29027
1507,24812,5652,18850,0.7597,0.2278,0.5319,13198,29029
1508,40328,10760,28907,0.7168,0.2668,0.45,18147,29031
1509,4532,786,3706,0.8177,0.1734,0.6443,2920,29033
1510,2897,418,2451,0.846,0.1443,0.7017,2033,29035
1511,57412,19052,37197,0.6479,0.3319,0.31600000000000006,18145,29037
1512,7044,1145,5788,0.8217,0.1625,0.6592,4643,29039
1513,4077,916,3111,0.7631,0.2247,0.5384,2195,29041
1514,46841,11131,34920,0.7455,0.2376,0.5079,23789,29043
1515,3394,678,2672,0.7873,0.1998,0.5875,1994,29045
1516,126577,59400,64605,0.5104,0.4693,0.04109999999999997,5205,29047
1517,10888,2896,7799,0.7163,0.266,0.45030000000000003,4903,29049
1518,39530,12694,26086,0.6599,0.3211,0.33880000000000005,13392,29051
1519,8693,2249,6272,0.7215,0.2587,0.46280000000000004,4023,29053
1520,10973,2113,8725,0.7951,0.1926,0.6025,6612,29055
1521,4119,656,3414,0.8288,0.1593,0.6695,2758,29057
1522,8104,1380,6619,0.8168,0.1703,0.6465,5239,29059
1523,3911,746,3102,0.7931,0.1907,0.6024,2356,29061
1524,4843,930,3828,0.7904,0.192,0.5984,2898,29063
1525,7142,1056,5987,0.8383,0.1479,0.6904,4931,29065
1526,7000,1016,5898,0.8426,0.1451,0.6975,4882,29067
1527,10419,2200,8135,0.7808,0.2112,0.5696000000000001,5935,29069
1528,53686,14569,38058,0.7089,0.2714,0.4375,23489,29071
1529,7923,1601,6222,0.7853,0.2021,0.5831999999999999,4621,29073
1530,3237,613,2581,0.7973,0.1894,0.6079,1968,29075
1531,141794,55068,83630,0.5898,0.3883,0.2015,28562,29077
1532,4437,799,3585,0.808,0.1801,0.6279,2786,29079
1533,3826,597,3198,0.8359,0.156,0.6799,2601,29081
1534,10788,2619,8027,0.7441,0.2428,0.5013,5408,29083
1535,5080,1056,3966,0.7807,0.2079,0.5728,2910,29085
1536,2343,338,1976,0.8434,0.1443,0.6991,1638,29087
1537,5092,1413,3553,0.6978,0.2775,0.42029999999999995,2140,29089
1538,18650,3218,15181,0.814,0.1725,0.6415,11963,29091
1539,4592,945,3596,0.7831,0.2058,0.5773,2651,29093
1540,333074,199842,126535,0.3799,0.6,-0.22009999999999996,-73307,29095
1541,52349,13549,37728,0.7207,0.2588,0.46190000000000003,24179,29097
1542,116683,37523,77046,0.6603,0.3216,0.3387,39523,29099
1543,23121,6974,15489,0.6699,0.3016,0.36830000000000007,8515,29101
1544,1854,340,1486,0.8015,0.1834,0.6181,1146,29103
1545,16793,2780,13762,0.8195,0.1655,0.654,10982,29105
1546,17055,4472,12273,0.7196,0.2622,0.45740000000000003,7801,29107
1547,17905,3214,14426,0.8057,0.1795,0.6262,11212,29109
1548,4609,984,3553,0.7709,0.2135,0.5574,2569,29111
1549,29018,6607,21848,0.7529,0.2277,0.5252,15241,29113
1550,5726,1275,4363,0.762,0.2227,0.5393,3088,29115
1551,6758,1410,5267,0.7794,0.2086,0.5708,3857,29117
1552,9053,1439,7465,0.8246,0.159,0.6656,6026,29119
1553,7836,1662,6076,0.7754,0.2121,0.5632999999999999,4414,29121
1554,5676,1019,4584,0.8076,0.1795,0.6281,3565,29123
1555,4771,814,3892,0.8158,0.1706,0.6452,3078,29125
1556,13348,3202,9915,0.7428,0.2399,0.5029,6713,29127
1557,1779,222,1541,0.8662,0.1248,0.7414,1319,29129
1558,12383,2038,10176,0.8218,0.1646,0.6572,8138,29131
1559,4756,1178,3537,0.7437,0.2477,0.496,2359,29133
1560,7157,1308,5744,0.8026,0.1828,0.6198,4436,29135
1561,4483,936,3477,0.7756,0.2088,0.5668,2541,29137
1562,5772,1208,4465,0.7736,0.2093,0.5642999999999999,3257,29139
1563,9488,1924,7442,0.7844,0.2028,0.5816,5518,29141
1564,7250,1748,5447,0.7513,0.2411,0.5102,3699,29143
1565,28406,5818,22120,0.7787,0.2048,0.5739,16302,29145
1566,9893,2853,6865,0.6939,0.2884,0.40549999999999997,4012,29147
1567,4739,823,3847,0.8118,0.1737,0.6381,3024,29149
1568,7539,1037,6425,0.8522,0.1376,0.7145999999999999,5388,29151
1569,4864,752,4064,0.8355,0.1546,0.6809000000000001,3312,29153
1570,5735,1560,4120,0.7184,0.272,0.4464,2560,29155
1571,9447,1664,7657,0.8105,0.1761,0.6344,5993,29157
1572,19096,4783,13854,0.7255,0.2505,0.47500000000000003,9071,29159
1573,19567,5637,13480,0.6889,0.2881,0.40079999999999993,7843,29161
1574,7695,1717,5863,0.7619,0.2231,0.5388000000000001,4146,29163
1575,57273,27179,28917,0.5049,0.4746,0.030299999999999994,1738,29165
1576,15065,2885,11850,0.7866,0.1915,0.5951,8965,29167
1577,14414,3740,10329,0.7166,0.2595,0.4571,6589,29169
1578,2361,361,1984,0.8403,0.1529,0.6874,1623,29171
1579,5662,1205,4396,0.7764,0.2128,0.5636,3191,29173
1580,10744,2485,8018,0.7463,0.2313,0.5149999999999999,5533,29175
1581,11649,3109,8345,0.7164,0.2669,0.4495,5236,29177
1582,3298,529,2733,0.8287,0.1604,0.6683,2204,29179
1583,5717,833,4839,0.8464,0.1457,0.7007000000000001,4006,29181
1584,222011,89530,128389,0.5783,0.4033,0.17500000000000004,38859,29183
1585,4974,988,3932,0.7905,0.1986,0.5919,2944,29185
1586,9484,2713,6630,0.6991,0.2861,0.41300000000000003,3917,29186
1587,28001,7044,20511,0.7325,0.2516,0.48090000000000005,13467,29187
1588,536416,328151,199493,0.3719,0.6117,-0.2398,-128658,29189
1589,9519,2904,6451,0.6777,0.3051,0.3726,3547,29195
1590,2003,373,1606,0.8018,0.1862,0.6155999999999999,1233,29197
1591,1984,388,1560,0.7863,0.1956,0.5907,1172,29199
1592,17718,3753,13769,0.7771,0.2118,0.5653,10016,29201
1593,3906,706,3165,0.8103,0.1807,0.6296,2459,29203
1594,3350,592,2700,0.806,0.1767,0.6293000000000001,2108,29205
1595,13425,1819,11484,0.8554,0.1355,0.7199,9665,29207
1596,18484,3506,14800,0.8007,0.1897,0.611,11294,29209
1597,2471,478,1974,0.7989,0.1934,0.6055,1496,29211
1598,26289,5339,20508,0.7801,0.2031,0.577,15169,29213
1599,11316,1716,9478,0.8376,0.1517,0.6859,7762,29215
1600,9185,1903,7155,0.779,0.2072,0.5718000000000001,5252,29217
1601,18374,4769,13222,0.7196,0.2595,0.4601,8453,29219
1602,9976,1804,8047,0.8066,0.1808,0.6258,6243,29221
1603,5878,845,4987,0.8484,0.1438,0.7046,4142,29223
1604,18778,3573,14880,0.7924,0.1903,0.6021,11307,29225
1605,1107,215,877,0.7922,0.1942,0.598,662,29227
1606,8739,1168,7453,0.8528,0.1337,0.7191,6285,29229
1607,133878,110089,21474,0.1604,0.8224,-0.662,-88615,29510
1608,5661,1608,3923,0.693,0.284,0.409,2315,30001
1609,4787,2491,2207,0.461,0.5204,-0.05939999999999995,-284,30003
1610,3118,1589,1469,0.4711,0.5096,-0.038500000000000034,-120,30005
1611,4097,835,3173,0.7745,0.2038,0.5707,2338,30007
1612,7053,2421,4468,0.6335,0.3433,0.29019999999999996,2047,30009
1613,864,74,775,0.897,0.0856,0.8114,701,30011
1614,39882,15456,23315,0.5846,0.3875,0.1971,7859,30013
1615,2965,991,1891,0.6378,0.3342,0.30360000000000004,900,30015
1616,5860,1514,4205,0.7176,0.2584,0.4592,2691,30017
1617,1014,195,799,0.788,0.1923,0.5957,604,30019
1618,4825,962,3758,0.7789,0.1994,0.5795,2796,30021
1619,4891,2562,2186,0.4469,0.5238,-0.07690000000000002,-376,30023
1620,1575,172,1375,0.873,0.1092,0.7638,1203,30025
1621,6507,1496,4869,0.7483,0.2299,0.5184,3373,30027
1622,59942,20274,38321,0.6393,0.3382,0.3011,18047,30029
1623,70988,37044,31696,0.4465,0.5218,-0.07530000000000003,-5348,30031
1624,813,41,764,0.9397,0.0504,0.8893,723,30033
1625,5617,3610,1884,0.3354,0.6427,-0.3073000000000001,-1726,30035
1626,503,78,414,0.8231,0.1551,0.668,336,30037
1627,2102,638,1419,0.6751,0.3035,0.37160000000000004,781,30039
1628,7181,2981,3957,0.551,0.4151,0.13590000000000002,976,30041
1629,8152,2625,5345,0.6557,0.322,0.33369999999999994,2720,30043
1630,1344,275,1040,0.7738,0.2046,0.5692,765,30045
1631,16626,6916,9322,0.5607,0.416,0.1447,2406,30047
1632,42277,19743,21409,0.5064,0.467,0.039399999999999935,1666,30049
1633,1083,249,821,0.7581,0.2299,0.5282,572,30051
1634,11749,2835,8672,0.7381,0.2413,0.4968,5837,30053
1635,1128,155,956,0.8475,0.1374,0.7101000000000001,801,30055
1636,6087,1771,4191,0.6885,0.2909,0.3976,2420,30057
1637,1110,258,833,0.7505,0.2324,0.5181,575,30059
1638,2563,686,1828,0.7132,0.2677,0.44549999999999995,1142,30061
1639,71498,43357,26347,0.3685,0.6064,-0.23790000000000006,-17010,30063
1640,2881,413,2423,0.841,0.1434,0.6976,2010,30065
1641,11569,5280,6025,0.5208,0.4564,0.06440000000000007,745,30067
1642,348,39,298,0.8563,0.1121,0.7442,259,30069
1643,2382,416,1936,0.8128,0.1746,0.6382,1520,30071
1644,2995,903,2031,0.6781,0.3015,0.37660000000000005,1128,30073
1645,1136,154,970,0.8539,0.1356,0.7182999999999999,816,30075
1646,3179,752,2355,0.7408,0.2366,0.5042,1603,30077
1647,744,126,603,0.8105,0.1694,0.6411,477,30079
1648,28507,8763,19114,0.6705,0.3074,0.3631,10351,30081
1649,5798,875,4800,0.8279,0.1509,0.6769999999999999,3925,30083
1650,4017,1910,1996,0.4969,0.4755,0.02140000000000003,86,30085
1651,3773,1199,2486,0.6589,0.3178,0.3411,1287,30087
1652,7623,1820,5660,0.7425,0.2388,0.5037,3840,30089
1653,2030,574,1403,0.6911,0.2828,0.40830000000000005,829,30091
1654,18658,10392,7745,0.4151,0.557,-0.14190000000000003,-2647,30093
1655,5724,1156,4462,0.7795,0.202,0.5774999999999999,3306,30095
1656,2446,549,1840,0.7522,0.2244,0.5278,1291,30097
1657,3679,1007,2608,0.7089,0.2737,0.4352,1601,30099
1658,2119,467,1596,0.7532,0.2204,0.5327999999999999,1129,30101
1659,460,78,373,0.8109,0.1696,0.6413,295,30103
1660,4261,1030,3135,0.7357,0.2417,0.494,2105,30105
1661,1068,225,823,0.7706,0.2107,0.5599,598,30107
1662,598,77,516,0.8629,0.1288,0.7341,439,30109
1663,83824,30679,50772,0.6057,0.366,0.23970000000000002,20093,30111
1664,14652,4213,10085,0.6883,0.2875,0.40080000000000005,5872,31001
1665,3587,452,3093,0.8623,0.126,0.7363,2641,31003
1666,285,21,260,0.9123,0.0737,0.8386,239,31005
1667,411,43,362,0.8808,0.1046,0.7762,319,31007
1668,317,35,280,0.8833,0.1104,0.7728999999999999,245,31009
1669,3226,499,2653,0.8224,0.1547,0.6677,2154,31011
1670,5200,1051,4002,0.7696,0.2021,0.5674999999999999,2951,31013
1671,1155,135,1010,0.8745,0.1169,0.7576,875,31015
1672,1684,191,1470,0.8729,0.1134,0.7595000000000001,1279,31017
1673,23710,6350,16640,0.7018,0.2678,0.434,10290,31019
1674,3739,1063,2580,0.69,0.2843,0.40569999999999995,1517,31021
1675,4518,873,3542,0.784,0.1932,0.5908,2669,31023
1676,15326,4737,10121,0.6604,0.3091,0.3513,5384,31025
1677,5015,725,4174,0.8323,0.1446,0.6877,3449,31027
1678,2000,226,1740,0.87,0.113,0.757,1514,31029
1679,3269,373,2844,0.87,0.1141,0.7559,2471,31031
1680,4776,855,3813,0.7984,0.179,0.6194,2958,31033
1681,3570,632,2848,0.7978,0.177,0.6208,2216,31035
1682,3726,1025,2636,0.7075,0.2751,0.4324,1611,31037
1683,4459,870,3507,0.7865,0.1951,0.5913999999999999,2637,31039
1684,6010,786,5090,0.8469,0.1308,0.7161,4304,31041
1685,6817,2744,3926,0.5759,0.4025,0.17339999999999994,1182,31043
1686,4151,1082,2931,0.7061,0.2607,0.44539999999999996,1849,31045
1687,9191,2497,6524,0.7098,0.2717,0.4381,4027,31047
1688,1034,141,871,0.8424,0.1364,0.7060000000000001,730,31049
1689,3094,651,2335,0.7547,0.2104,0.5443,1684,31051
1690,16938,5544,10984,0.6485,0.3273,0.3212,5440,31053
1691,276535,150350,119159,0.4309,0.5437,-0.11279999999999996,-31191,31055
1692,1003,105,883,0.8804,0.1047,0.7757,778,31057
1693,3148,693,2359,0.7494,0.2201,0.5293,1666,31059
1694,1728,276,1437,0.8316,0.1597,0.6718999999999999,1161,31061
1695,1446,189,1229,0.8499,0.1307,0.7192,1040,31063
1696,2602,399,2163,0.8313,0.1533,0.678,1764,31065
1697,11119,3385,7445,0.6696,0.3044,0.36519999999999997,4060,31067
1698,1200,161,1016,0.8467,0.1342,0.7125,855,31069
1699,1076,133,933,0.8671,0.1236,0.7434999999999999,800,31071
1700,1121,215,893,0.7966,0.1918,0.6048,678,31073
1701,402,20,375,0.9328,0.0498,0.883,355,31075
1702,1259,229,1016,0.807,0.1819,0.6251,787,31077
1703,24451,7681,16189,0.6621,0.3142,0.34790000000000004,8508,31079
1704,5566,1118,4309,0.7742,0.2009,0.5733,3191,31081
1705,1934,282,1615,0.8351,0.1458,0.6892999999999999,1333,31083
1706,536,34,494,0.9216,0.0634,0.8582,460,31085
1707,1470,175,1264,0.8599,0.119,0.7409,1089,31087
1708,5550,686,4769,0.8593,0.1236,0.7356999999999999,4083,31089
1709,442,59,376,0.8507,0.1335,0.7172000000000001,317,31091
1710,3511,648,2786,0.7935,0.1846,0.6089,2138,31093
1711,3730,1016,2616,0.7013,0.2724,0.42890000000000006,1600,31095
1712,2233,647,1518,0.6798,0.2897,0.39009999999999995,871,31097
1713,3617,701,2822,0.7802,0.1938,0.5864,2121,31099
1714,4369,763,3544,0.8112,0.1746,0.6366,2781,31101
1715,530,49,476,0.8981,0.0925,0.8056,427,31103
1716,1877,268,1563,0.8327,0.1428,0.6899,1295,31105
1717,4708,905,3721,0.7904,0.1922,0.5982,2816,31107
1718,157227,82293,70092,0.4458,0.5234,-0.0776,-12201,31109
1719,17163,3692,13071,0.7616,0.2151,0.5465,9379,31111
1720,450,38,407,0.9044,0.0844,0.82,369,31113
1721,454,75,370,0.815,0.1652,0.6497999999999999,295,31115
1722,302,17,275,0.9106,0.0563,0.8543,258,31117
1723,15819,3478,11940,0.7548,0.2199,0.5349,8462,31119
1724,4282,743,3419,0.7985,0.1735,0.625,2676,31121
1725,2558,386,2113,0.826,0.1509,0.6750999999999999,1727,31123
1726,1832,359,1437,0.7844,0.196,0.5884,1078,31125
1727,3432,921,2428,0.7075,0.2684,0.4391,1507,31127
1728,2305,409,1857,0.8056,0.1774,0.6282,1448,31129
1729,8355,2490,5649,0.6761,0.298,0.37810000000000005,3159,31131
1730,1429,322,1071,0.7495,0.2253,0.5242,749,31133
1731,1545,199,1321,0.855,0.1288,0.7262,1122,31135
1732,5021,752,4157,0.8279,0.1498,0.6780999999999999,3405,31137
1733,4012,480,3462,0.8629,0.1196,0.7433,2982,31139
1734,15722,3260,12186,0.7751,0.2074,0.5677,8926,31141
1735,2887,530,2291,0.7936,0.1836,0.61,1761,31143
1736,5470,811,4525,0.8272,0.1483,0.6789000000000001,3714,31145
1737,4134,996,3073,0.7433,0.2409,0.5024,2077,31147
1738,842,84,744,0.8836,0.0998,0.7838,660,31149
1739,5780,1986,3631,0.6282,0.3436,0.28459999999999996,1645,31151
1740,96186,41206,51979,0.5404,0.4284,0.11199999999999999,10773,31153
1741,12787,3331,9108,0.7123,0.2605,0.45180000000000003,5777,31155
1742,15524,4196,10952,0.7055,0.2703,0.43520000000000003,6756,31157
1743,9199,2438,6490,0.7055,0.265,0.4405,4052,31159
1744,2684,340,2292,0.8539,0.1267,0.7272,1952,31161
1745,1700,343,1322,0.7776,0.2018,0.5758,979,31163
1746,731,72,642,0.8782,0.0985,0.7797,570,31165
1747,3165,532,2561,0.8092,0.1681,0.6411,2029,31167
1748,2989,624,2308,0.7722,0.2088,0.5634,1684,31169
1749,427,45,377,0.8829,0.1054,0.7775000000000001,332,31171
1750,2379,1122,1180,0.496,0.4716,0.024399999999999977,58,31173
1751,2344,412,1901,0.811,0.1758,0.6352,1489,31175
1752,12466,3554,8583,0.6885,0.2851,0.4034,5029,31177
1753,4218,1022,3055,0.7243,0.2423,0.4820000000000001,2033,31179
1754,1876,335,1511,0.8054,0.1786,0.6268,1176,31181
1755,503,59,438,0.8708,0.1173,0.7535000000000001,379,31183
1756,7161,1630,5337,0.7453,0.2276,0.5176999999999999,3707,31185
1757,12890,3051,9372,0.7271,0.2367,0.49039999999999995,6321,32001
1758,972534,521852,430930,0.4431,0.5366,-0.09349999999999997,-90922,32003
1759,34127,11571,21630,0.6338,0.3391,0.2947,10059,32005
1760,21967,4557,16741,0.7621,0.2074,0.5547,12184,32007
1761,487,74,400,0.8214,0.152,0.6694,326,32009
1762,1017,105,895,0.88,0.1032,0.7768,790,32011
1763,7771,1689,5877,0.7563,0.2173,0.5389999999999999,4188,32013
1764,2765,496,2198,0.7949,0.1794,0.6155,1702,32015
1765,2446,330,2067,0.8451,0.1349,0.7101999999999999,1737,32017
1766,30240,8473,20914,0.6916,0.2802,0.4114,12441,32019
1767,2335,829,1423,0.6094,0.355,0.25440000000000007,594,32021
1768,25377,7288,17528,0.6907,0.2872,0.40349999999999997,10240,32023
1769,2320,547,1731,0.7461,0.2358,0.5103,1184,32027
1770,2877,902,1908,0.6632,0.3135,0.3497,1006,32029
1771,252127,128128,116760,0.4631,0.5082,-0.04509999999999997,-11368,32031
1772,4369,859,3403,0.7789,0.1966,0.5823,2544,32033
1773,29740,12735,16113,0.5418,0.4282,0.11359999999999992,3378,32510
1774,38481,16894,20899,0.5431,0.439,0.10410000000000003,4005,33001
1775,33299,16649,16150,0.485,0.5,-0.015000000000000013,-499,33003
1776,44342,25506,17892,0.4035,0.5751,-0.17159999999999992,-7614,33005
1777,16543,7640,8617,0.5209,0.4618,0.05910000000000004,977,33007
1778,54134,33180,19905,0.3677,0.6129,-0.24519999999999997,-13275,33009
1779,231676,122344,104625,0.4516,0.5281,-0.07650000000000001,-17719,33011
1780,90129,48533,39711,0.4406,0.5385,-0.09789999999999999,-8822,33013
1781,199330,100064,95858,0.4809,0.502,-0.021100000000000008,-4206,33015
1782,73805,41721,30489,0.4131,0.5653,-0.1522,-11232,33017
1783,24444,12390,11508,0.4708,0.5069,-0.03610000000000002,-882,33019
1784,140022,73808,64438,0.4602,0.5271,-0.06690000000000002,-9370,34001
1785,497849,285967,204417,0.4106,0.5744,-0.1638,-81550,34003
1786,262630,154595,103345,0.3935,0.5886,-0.1951,-51250,34005
1787,265579,175065,86207,0.3246,0.6591,-0.3345,-88858,34007
1788,57928,23941,33158,0.5724,0.4133,0.15910000000000002,9217,34009
1789,62572,32742,28952,0.4627,0.5232,-0.0605,-3790,34011
1790,345265,266820,75475,0.2186,0.7727,-0.5541,-191345,34013
1791,173444,86702,83340,0.4805,0.4999,-0.01940000000000003,-3362,34015
1792,250469,181452,65698,0.2623,0.7245,-0.46220000000000006,-115754,34017
1793,84680,39457,43153,0.5096,0.466,0.04360000000000003,3696,34019
1794,177217,122532,51641,0.2914,0.6914,-0.4,-70891,34021
1795,375666,226250,143467,0.3819,0.6022,-0.22029999999999994,-82783,34023
1796,378394,181291,191808,0.5069,0.4791,0.02779999999999999,10517,34025
1797,300925,153881,141134,0.469,0.5114,-0.04239999999999999,-12747,34027
1798,342736,119456,217740,0.6353,0.3485,0.2868,98284,34029
1799,224303,129097,92009,0.4102,0.5755,-0.1653,-37088,34031
1800,34039,14479,18827,0.5531,0.4253,0.12780000000000002,4348,34033
1801,186906,111173,71996,0.3852,0.5949,-0.2097,-39177,34035
1802,88358,34481,51698,0.5851,0.3903,0.19479999999999997,17217,34037
1803,254055,170245,80002,0.3149,0.6701,-0.3552,-90243,34039
1804,61052,24901,34769,0.5695,0.4078,0.1617,9868,34041
1805,317569,193757,116135,0.3657,0.6101,-0.24439999999999995,-77622,35001
1806,2326,595,1698,0.73,0.2558,0.47419999999999995,1103,35003
1807,22443,6381,15656,0.6976,0.2843,0.4133,9275,35005
1808,8903,4745,3975,0.4465,0.533,-0.08650000000000002,-770,35006
1809,6016,2611,3271,0.5437,0.434,0.10969999999999996,660,35007
1810,15101,4307,10444,0.6916,0.2852,0.4064,6137,35009
1811,901,231,656,0.7281,0.2564,0.47169999999999995,425,35011
1812,82646,47957,32802,0.3969,0.5803,-0.18340000000000006,-15155,35013
1813,23222,5424,17454,0.7516,0.2336,0.518,12030,35015
1814,14434,7590,6553,0.454,0.5258,-0.07180000000000003,-1037,35017
1815,2189,1234,917,0.4189,0.5637,-0.14479999999999998,-317,35019
1816,505,179,319,0.6317,0.3545,0.27720000000000006,140,35021
1817,1974,823,1120,0.5674,0.4169,0.15050000000000002,297,35023
1818,20917,4061,16531,0.7903,0.1941,0.5962000000000001,12470,35025
1819,10306,3194,6942,0.6736,0.3099,0.36369999999999997,3748,35027
1820,12293,7554,4278,0.348,0.6145,-0.26650000000000007,-3276,35028
1821,8103,3563,4408,0.544,0.4397,0.10430000000000006,845,35029
1822,26489,18029,7801,0.2945,0.6807,-0.3862,-10228,35031
1823,2686,1745,903,0.3362,0.6497,-0.31350000000000006,-842,35033
1824,23569,8485,14521,0.6161,0.36,0.2561,6036,35035
1825,3873,1170,2634,0.6801,0.3021,0.37800000000000006,1464,35037
1826,16630,10990,5408,0.3252,0.6609,-0.33570000000000005,-5582,35039
1827,6608,1802,4634,0.7013,0.2727,0.42860000000000004,2832,35041
1828,76555,40588,34174,0.4464,0.5301,-0.0837,-6414,35043
1829,52297,18083,32874,0.6286,0.3458,0.28280000000000005,14791,35045
1830,11530,7888,3421,0.2967,0.6841,-0.3874,-4467,35047
1831,82230,62530,18329,0.2229,0.7605,-0.5376,-44201,35049
1832,5945,2265,3542,0.5958,0.381,0.2148,1277,35051
1833,7160,3722,3255,0.4546,0.5198,-0.06520000000000004,-467,35053
1834,17183,13121,3715,0.2162,0.7637,-0.5475000000000001,-9406,35055
1835,7281,2344,4772,0.6554,0.3219,0.33349999999999996,2428,35057
1836,1789,383,1388,0.7759,0.2141,0.5618000000000001,1005,35059
1837,32275,14263,17364,0.538,0.4419,0.09610000000000002,3101,35061
1838,154090,99474,51081,0.3315,0.6455,-0.31399999999999995,-48393,36001
1839,20784,6051,14135,0.6801,0.2911,0.389,8084,36003
1840,426574,355374,67740,0.1588,0.8329,-0.6740999999999999,-287634,36005
1841,93112,47010,43800,0.4704,0.5049,-0.03450000000000003,-3210,36007
1842,34824,11879,22155,0.6362,0.3411,0.2951,10276,36009
1843,36478,16149,19512,0.5349,0.4427,0.09220000000000006,3363,36011
1844,59304,23087,34853,0.5877,0.3893,0.19840000000000002,11766,36013
1845,39485,16636,21922,0.5552,0.4213,0.13390000000000002,5286,36015
1846,22317,8290,13482,0.6041,0.3714,0.23269999999999996,5192,36017
1847,35499,18364,16514,0.4652,0.5173,-0.05209999999999998,-1850,36019
1848,35599,20386,14464,0.4063,0.5726,-0.1663,-5922,36021
1849,21717,10369,10789,0.4968,0.4775,0.01930000000000004,420,36023
1850,23021,9143,13387,0.5815,0.3971,0.1844,4244,36025
1851,151123,81443,66872,0.4425,0.5389,-0.09640000000000004,-14571,36027
1852,474482,267174,197527,0.4163,0.5631,-0.14680000000000004,-69647,36029
1853,19320,9947,8976,0.4646,0.5149,-0.05030000000000001,-971,36031
1854,19270,9253,9668,0.5017,0.4802,0.02150000000000002,415,36033
1855,23746,7931,15378,0.6476,0.334,0.31359999999999993,7447,36035
1856,29220,9625,18876,0.646,0.3294,0.3166,9251,36037
1857,25196,10346,14271,0.5664,0.4107,0.1557,3925,36039
1858,3461,1178,2225,0.6429,0.3404,0.30250000000000005,1047,36041
1859,29365,9937,18870,0.6426,0.3384,0.30419999999999997,8933,36043
1860,43923,17307,25629,0.5835,0.394,0.1895,8322,36045
1861,915863,703310,202772,0.2214,0.7678,-0.5464,-500538,36047
1862,12976,3824,8894,0.6854,0.2947,0.3907,5070,36049
1863,31468,12477,18182,0.5778,0.3965,0.18129999999999996,5705,36051
1864,34127,14807,18408,0.5394,0.4339,0.10549999999999998,3601,36053
1865,379919,225746,145661,0.3834,0.5943,-0.21090000000000003,-80085,36055
1866,21154,7977,12745,0.6025,0.3771,0.22540000000000004,4768,36057
1867,732711,396504,326716,0.4459,0.5411,-0.0952,-69788,36059
1868,697666,603040,85185,0.1221,0.8642,-0.7421,-517855,36061
1869,104119,46029,56068,0.5385,0.4421,0.09639999999999999,10039,36063
1870,100918,41567,57180,0.5666,0.4119,0.1547,15613,36065
1871,235558,138894,90619,0.3847,0.5896,-0.20490000000000003,-48275,36067
1872,59850,29025,29039,0.4852,0.485,0.00020000000000003348,14,36069
1873,172511,84684,84996,0.4927,0.4908,0.0019000000000000128,312,36071
1874,18161,5587,12126,0.6677,0.3076,0.3601,6539,36073
1875,54610,21143,32138,0.5885,0.3871,0.20140000000000002,10995,36075
1876,28079,12975,14382,0.5122,0.4621,0.05009999999999998,1407,36077
1877,55115,24949,29277,0.5312,0.4527,0.07850000000000001,4328,36079
1878,789989,569038,212665,0.2692,0.7203,-0.45110000000000006,-356373,36081
1879,79417,40969,36500,0.4596,0.5159,-0.05630000000000002,-4469,36083
1880,216769,90997,123320,0.5689,0.4198,0.14909999999999995,32323,36085
1881,150713,75802,73186,0.4856,0.503,-0.017400000000000027,-2616,36087
1882,44905,19361,24608,0.548,0.4311,0.11690000000000006,5247,36089
1883,132954,68471,61305,0.4611,0.5149,-0.053800000000000014,-7166,36091
1884,75033,42465,30741,0.4097,0.566,-0.15629999999999994,-11724,36093
1885,15709,5345,9903,0.6304,0.3402,0.29019999999999996,4558,36095
1886,9765,3903,5621,0.5756,0.3997,0.1759,1718,36097
1887,15633,6914,8329,0.5328,0.4423,0.09050000000000002,1415,36099
1888,46255,15790,29474,0.6372,0.3414,0.2958,13684,36101
1889,771767,381021,381253,0.494,0.4937,0.00029999999999996696,232,36103
1890,34700,15489,18665,0.5379,0.4464,0.09150000000000003,3176,36105
1891,25044,9634,14791,0.5906,0.3847,0.20590000000000003,5157,36107
1892,45851,33619,11096,0.242,0.7332,-0.49119999999999997,-22523,36109
1893,97662,57970,37590,0.3849,0.5936,-0.2087,-20380,36111
1894,36209,17642,17699,0.4888,0.4872,0.0015999999999999903,57,36113
1895,28139,11565,15941,0.5665,0.411,0.15550000000000003,4376,36115
1896,44793,17456,26204,0.585,0.3897,0.19529999999999997,8748,36117
1897,462194,312371,144713,0.3131,0.6757,-0.3626,-167658,36119
1898,19431,5073,13897,0.7152,0.2611,0.45409999999999995,8824,36121
1899,10724,4219,6208,0.5789,0.3935,0.18539999999999995,1989,36123
1900,86086,38825,46056,0.535,0.451,0.08400000000000002,7231,37001
1901,20237,4145,15888,0.7851,0.2048,0.5803,11743,37003
1902,6076,1486,4527,0.7451,0.2446,0.5005,3041,37005
1903,11195,5789,5321,0.4753,0.5172,-0.04189999999999999,-468,37007
1904,15814,4164,11451,0.7241,0.2633,0.4608,7287,37009
1905,9458,2191,7172,0.7583,0.2317,0.5266,4981,37011
1906,26316,9633,16437,0.6246,0.3661,0.25850000000000006,6804,37013
1907,9815,5939,3817,0.3889,0.6051,-0.21619999999999995,-2122,37015
1908,17126,7326,9676,0.565,0.4278,0.13719999999999993,2350,37017
1909,90168,33310,55850,0.6194,0.3694,0.24999999999999994,22540,37019
1910,161564,96515,62412,0.3863,0.5974,-0.21110000000000007,-34103,37021
1911,44600,13118,31019,0.6955,0.2941,0.40140000000000003,17901,37023
1912,117236,52162,63237,0.5394,0.445,0.09439999999999998,11075,37025
1913,42831,10245,32119,0.7499,0.2392,0.5107,21874,37027
1914,5953,1537,4312,0.7243,0.2582,0.46610000000000007,2775,37029
1915,42696,12093,30028,0.7033,0.2832,0.42010000000000003,17935,37031
1916,12052,4860,7089,0.5882,0.4033,0.18489999999999995,2229,37033
1917,83426,25689,56588,0.6783,0.3079,0.3704,30899,37035
1918,48603,26787,21186,0.4359,0.5512,-0.11530000000000001,-5601,37037
1919,16423,3583,12628,0.7689,0.2182,0.5507,9045,37039
1920,7784,3247,4471,0.5744,0.4171,0.1573,1224,37041
1921,6893,1699,5112,0.7416,0.2465,0.49510000000000004,3413,37043
1922,51310,16955,33798,0.6587,0.3305,0.32819999999999994,16843,37045
1923,26445,9446,16832,0.6365,0.3572,0.27929999999999994,7386,37047
1924,53064,21148,31032,0.5848,0.3985,0.18629999999999997,9884,37049
1925,147137,84469,60032,0.408,0.574,-0.16599999999999998,-24437,37051
1926,16148,4195,11657,0.7219,0.2598,0.4621,7462,37053
1927,24232,9936,13938,0.5752,0.41,0.16520000000000007,4002,37055
1928,88512,22636,64658,0.7305,0.2557,0.47480000000000006,42022,37057
1929,25310,6713,18228,0.7202,0.2652,0.45499999999999996,11515,37059
1930,22716,8767,13793,0.6072,0.386,0.22119999999999995,5026,37061
1931,179928,144688,32459,0.1804,0.8042,-0.6238,-112229,37063
1932,25480,16089,9206,0.3613,0.6315,-0.27019999999999994,-6883,37065
1933,201287,113033,85064,0.4226,0.5616,-0.139,-27969,37067
1934,37350,15879,20901,0.5596,0.4251,0.1345,5022,37069
1935,115504,40959,73033,0.6323,0.3546,0.27769999999999995,32074,37071
1936,5971,2546,3367,0.5639,0.4264,0.13749999999999996,821,37073
1937,4665,905,3710,0.7953,0.194,0.6013,2805,37075
1938,31600,14565,16647,0.5268,0.4609,0.06590000000000007,2082,37077
1939,8754,3832,4874,0.5568,0.4378,0.11899999999999994,1042,37079
1940,284449,173086,107294,0.3772,0.6084,-0.23120000000000007,-65792,37081
1941,25760,15545,10080,0.3913,0.6035,-0.21220000000000006,-5465,37083
1942,58288,22093,35177,0.6035,0.379,0.22450000000000003,13084,37085
1943,36540,13144,22834,0.6249,0.3597,0.2652,9690,37087
1944,68372,27211,40032,0.5855,0.398,0.1875,12821,37089
1945,10633,7097,3479,0.3272,0.6674,-0.3402,-3618,37091
1946,21637,11804,9453,0.4369,0.5455,-0.10859999999999997,-2351,37093
1947,2492,1046,1418,0.569,0.4197,0.14929999999999993,372,37095
1948,102368,33888,67010,0.6546,0.331,0.32359999999999994,33122,37097
1949,21426,9591,11356,0.53,0.4476,0.08240000000000003,1765,37099
1950,111360,41257,68353,0.6138,0.3705,0.24330000000000002,27096,37101
1951,5525,2197,3280,0.5937,0.3976,0.1961,1083,37103
1952,29010,12143,16469,0.5677,0.4186,0.14909999999999995,4326,37105
1953,28407,13605,14590,0.5136,0.4789,0.03469999999999995,985,37107
1954,50216,13274,36341,0.7237,0.2643,0.45940000000000003,23067,37109
1955,23004,5832,16883,0.7339,0.2535,0.4804,11051,37111
1956,20743,6230,14211,0.6851,0.3003,0.38480000000000003,7981,37113
1957,13076,4901,7979,0.6102,0.3748,0.23539999999999994,3078,37115
1958,12540,5911,6532,0.5209,0.4714,0.049500000000000044,621,37117
1959,567123,378107,179211,0.316,0.6668,-0.35079999999999995,-198896,37119
1960,9041,1867,7090,0.7842,0.2065,0.5777,5223,37121
1961,12849,4327,8411,0.6546,0.3368,0.31779999999999997,4084,37123
1962,58337,20779,36764,0.6302,0.3562,0.27399999999999997,15985,37125
1963,52271,25947,25827,0.4941,0.4964,-0.0023000000000000242,-120,37127
1964,131830,66138,63331,0.4804,0.5017,-0.02130000000000004,-2807,37129
1965,10109,6069,3989,0.3946,0.6003,-0.20569999999999994,-2080,37131
1966,72234,24266,46078,0.6379,0.3359,0.30200000000000005,21812,37133
1967,84987,63594,20176,0.2374,0.7482,-0.5107999999999999,-43418,37135
1968,7631,2713,4849,0.6354,0.3555,0.2799,2136,37137
1969,19898,9832,9770,0.491,0.4941,-0.0030999999999999917,-62,37139
1970,34167,11723,21956,0.6426,0.3431,0.29949999999999993,10233,37141
1971,7484,2492,4903,0.6551,0.333,0.3221,2411,37143
1972,21893,8465,13184,0.6022,0.3866,0.21559999999999996,4719,37145
1973,87580,47252,38982,0.4451,0.5396,-0.09449999999999997,-8270,37147
1974,12358,4518,7689,0.6222,0.3656,0.2566,3171,37149
1975,73317,15618,56894,0.776,0.213,0.5630000000000001,41276,37151
1976,20762,8754,11830,0.5698,0.4216,0.1482,3076,37153
1977,47185,19020,27806,0.5893,0.4031,0.18620000000000003,8786,37155
1978,47810,15992,31301,0.6547,0.3345,0.32019999999999993,15309,37157
1979,73413,23114,49297,0.6715,0.3149,0.3566,26183,37159
1980,34427,9135,24891,0.723,0.2653,0.4577,15756,37161
1981,28618,10966,17411,0.6084,0.3832,0.22520000000000007,6445,37163
1982,14775,7186,7473,0.5058,0.4864,0.01940000000000003,287,37165
1983,33939,8129,25458,0.7501,0.2395,0.5105999999999999,17329,37167
1984,25701,5286,20142,0.7837,0.2057,0.578,14856,37169
1985,36639,8721,27538,0.7516,0.238,0.5136000000000001,18817,37171
1986,7068,2780,4161,0.5887,0.3933,0.19540000000000002,1381,37173
1987,20403,8444,11636,0.5703,0.4138,0.15650000000000003,3192,37175
1988,1817,758,1044,0.5746,0.4172,0.15739999999999998,286,37177
1989,131001,48725,80382,0.6136,0.3719,0.24170000000000003,31657,37179
1990,20998,12431,8391,0.3996,0.592,-0.19239999999999996,-4040,37181
1991,631835,393336,226197,0.358,0.6225,-0.26450000000000007,-167139,37183
1992,10294,6400,3752,0.3645,0.6218,-0.25730000000000003,-2648,37185
1993,6205,3396,2781,0.4482,0.5473,-0.09910000000000002,-615,37187
1994,32221,17122,14451,0.4485,0.5314,-0.08289999999999997,-2671,37189
1995,55542,24215,30709,0.5529,0.436,0.11689999999999995,6494,37191
1996,35465,7511,27592,0.778,0.2118,0.5662,20081,37193
1997,40734,20754,19581,0.4807,0.5095,-0.028799999999999937,-1173,37195
1998,19924,3763,15933,0.7997,0.1889,0.6108,12170,37197
1999,11352,3688,7516,0.6621,0.3249,0.3372,3828,37199
2000,1269,258,981,0.773,0.2033,0.5697,723,38001
2001,5565,1820,3568,0.6412,0.327,0.3142,1748,38003
2002,1961,822,1094,0.5579,0.4192,0.13869999999999993,272,38005
2003,635,72,541,0.852,0.1134,0.7385999999999999,469,38007
2004,3471,821,2575,0.7419,0.2365,0.5054000000000001,1754,38009
2005,1657,228,1395,0.8419,0.1376,0.7042999999999999,1167,38011
2006,1155,137,994,0.8606,0.1186,0.742,857,38013
2007,50751,14348,34744,0.6846,0.2827,0.4019,20396,38015
2008,86047,40311,42619,0.4953,0.4684,0.026900000000000035,2308,38017
2009,2020,474,1499,0.7421,0.2347,0.5074,1025,38019
2010,2424,608,1742,0.7186,0.2508,0.4678,1134,38021
2011,1202,265,904,0.7521,0.2205,0.5316,639,38023
2012,2338,342,1951,0.8345,0.1463,0.6882,1609,38025
2013,1261,383,854,0.6772,0.3037,0.3735,471,38027
2014,2009,237,1738,0.8651,0.118,0.7471,1501,38029
2015,1778,373,1362,0.766,0.2098,0.5562,989,38031
2016,1026,137,871,0.8489,0.1335,0.7154,734,38033
2017,30970,12880,16987,0.5485,0.4159,0.1326,4107,38035
2018,1381,207,1145,0.8291,0.1499,0.6791999999999999,938,38037
2019,1250,308,907,0.7256,0.2464,0.4792,599,38039
2020,1312,196,1091,0.8316,0.1494,0.6822,895,38041
2021,1460,221,1215,0.8322,0.1514,0.6808000000000001,994,38043
2022,2219,527,1645,0.7413,0.2375,0.5038,1118,38045
2023,1076,128,930,0.8643,0.119,0.7453,802,38047
2024,3003,564,2364,0.7872,0.1878,0.5994,1800,38049
2025,1455,261,1153,0.7924,0.1794,0.613,892,38051
2026,5419,814,4482,0.8271,0.1502,0.6769,3668,38053
2027,5536,1230,4198,0.7583,0.2222,0.5361,2968,38055
2028,4675,704,3856,0.8248,0.1506,0.6741999999999999,3152,38057
2029,16619,3872,12243,0.7367,0.233,0.5037,8371,38059
2030,4165,1256,2824,0.678,0.3016,0.37640000000000007,1568,38061
2031,1777,586,1141,0.6421,0.3298,0.3123,555,38063
2032,1066,129,918,0.8612,0.121,0.7402,789,38065
2033,3331,786,2460,0.7385,0.236,0.5025000000000001,1674,38067
2034,2128,497,1585,0.7448,0.2336,0.5112,1088,38069
2035,5372,1639,3577,0.6659,0.3051,0.36080000000000007,1938,38071
2036,2454,945,1418,0.5778,0.3851,0.19269999999999998,473,38073
2037,1319,220,1065,0.8074,0.1668,0.6406000000000001,845,38075
2038,7811,2510,5072,0.6493,0.3213,0.328,2562,38077
2039,3804,2482,1257,0.3304,0.6525,-0.32209999999999994,-1225,38079
2040,2070,738,1266,0.6116,0.3565,0.25510000000000005,528,38081
2041,812,104,688,0.8473,0.1281,0.7192000000000001,584,38083
2042,1186,804,258,0.2175,0.6779,-0.4603999999999999,-546,38085
2043,427,44,380,0.8899,0.103,0.7869,336,38087
2044,15049,2499,12110,0.8047,0.166,0.6386999999999999,9611,38089
2045,1088,392,652,0.5993,0.3603,0.23900000000000005,260,38091
2046,9959,2676,6994,0.7023,0.2687,0.43360000000000004,4318,38093
2047,1174,317,830,0.707,0.27,0.43699999999999994,513,38095
2048,4136,1493,2522,0.6098,0.361,0.24880000000000002,1029,38097
2049,4783,1333,3324,0.695,0.2787,0.41629999999999995,1991,38099
2050,28248,7293,19974,0.7071,0.2582,0.44889999999999997,12681,38101
2051,2374,442,1893,0.7974,0.1862,0.6112,1451,38103
2052,14333,2169,11739,0.819,0.1513,0.6677,9570,38105
2053,12145,2156,9870,0.8127,0.1775,0.6352,7714,39001
2054,48099,14149,33116,0.6885,0.2942,0.3943,18967,39003
2055,26404,6541,19407,0.735,0.2477,0.48729999999999996,12866,39005
2056,44234,16497,26890,0.6079,0.3729,0.235,10393,39007
2057,26123,14772,10862,0.4158,0.5655,-0.1497,-3910,39009
2058,25823,4651,20798,0.8054,0.1801,0.6253,16147,39011
2059,33141,9138,23560,0.7109,0.2757,0.4352,14422,39013
2060,21139,4380,16480,0.7796,0.2072,0.5724,12100,39015
2061,186732,69613,114392,0.6126,0.3728,0.2398,44779,39017
2062,14234,3251,10745,0.7549,0.2284,0.5265,7494,39019
2063,20004,5062,14589,0.7293,0.2531,0.47619999999999996,9527,39021
2064,64356,24076,39032,0.6065,0.3741,0.23240000000000005,14956,39023
2065,110704,34092,74570,0.6736,0.3079,0.36569999999999997,40478,39025
2066,20563,4697,15488,0.7532,0.2284,0.5247999999999999,10791,39027
2067,49959,13359,35726,0.7151,0.2674,0.44769999999999993,22367,39029
2068,16769,4125,12325,0.735,0.246,0.489,8200,39031
2069,20714,4916,15436,0.7452,0.2373,0.5079,10520,39033
2070,627163,416176,202699,0.3232,0.6636,-0.3404,-213477,39035
2071,27162,4731,22004,0.8101,0.1742,0.6359,17273,39037
2072,19382,5981,13038,0.6727,0.3086,0.3641,7057,39039
2073,126368,57735,66356,0.5251,0.4569,0.06820000000000004,8621,39041
2074,40416,17493,22160,0.5483,0.4328,0.11549999999999999,4667,39043
2075,83315,31224,50797,0.6097,0.3748,0.2349,19573,39045
2076,12626,2975,9473,0.7503,0.2356,0.5146999999999999,6498,39047
2077,632446,409144,211237,0.334,0.6468,-0.3128,-197907,39049
2078,22805,6664,15731,0.6898,0.2922,0.39759999999999995,9067,39051
2079,13800,2990,10645,0.7714,0.2167,0.5547,7655,39053
2080,56018,21201,34143,0.6095,0.3784,0.23110000000000003,12942,39055
2081,88648,34798,52072,0.5874,0.3926,0.19480000000000003,17274,39057
2082,18263,4577,13407,0.7341,0.2506,0.4835,8830,39059
2083,430925,246266,177886,0.4128,0.5715,-0.1587,-68380,39061
2084,38771,11757,26310,0.6786,0.3032,0.37539999999999996,14553,39063
2085,13248,3062,9949,0.751,0.2311,0.5199,6887,39065
2086,7663,1768,5792,0.7558,0.2307,0.5251,4024,39067
2087,14788,4062,10479,0.7086,0.2747,0.4339,6417,39069
2088,19676,3799,15678,0.7968,0.1931,0.6036999999999999,11879,39071
2089,13855,3880,9737,0.7028,0.28,0.42279999999999995,5857,39073
2090,12978,1994,10796,0.8319,0.1536,0.6783,8802,39075
2091,27189,7759,18956,0.6972,0.2854,0.41180000000000005,11197,39077
2092,14810,3311,11309,0.7636,0.2236,0.5399999999999999,7998,39079
2093,33423,10018,22828,0.683,0.2998,0.38320000000000004,12810,39081
2094,31460,8589,22340,0.7101,0.273,0.43709999999999993,13751,39083
2095,130784,55514,73278,0.5603,0.4245,0.13580000000000003,17764,39085
2096,28179,7489,20306,0.7206,0.2658,0.45480000000000004,12817,39087
2097,94392,33055,59514,0.6305,0.3502,0.28029999999999994,26459,39089
2098,23409,5055,17964,0.7674,0.2159,0.5515,12909,39091
2099,157778,75667,79520,0.504,0.4796,0.024399999999999977,3853,39093
2100,201090,115411,81763,0.4066,0.5739,-0.16729999999999995,-33648,39095
2101,19886,5698,13835,0.6957,0.2865,0.4092,8137,39097
2102,119186,57641,59903,0.5026,0.4836,0.019000000000000072,2262,39099
2103,27873,8269,19023,0.6825,0.2967,0.3858,10754,39101
2104,106037,39800,64598,0.6092,0.3753,0.23389999999999994,24798,39103
2105,10967,2492,8316,0.7583,0.2272,0.5310999999999999,5824,39105
2106,23783,4030,19452,0.8179,0.1694,0.6485,15422,39107
2107,58081,15663,41371,0.7123,0.2697,0.44260000000000005,25708,39109
2108,7159,1605,5463,0.7631,0.2242,0.5388999999999999,3858,39111
2109,269157,135064,129034,0.4794,0.5018,-0.02240000000000003,-6030,39113
2110,6856,1725,5041,0.7353,0.2516,0.48369999999999996,3316,39115
2111,18469,4048,14077,0.7622,0.2192,0.5429999999999999,10029,39117
2112,40469,11971,27867,0.6886,0.2958,0.3928,15896,39119
2113,6348,1170,5135,0.8089,0.1843,0.6245999999999999,3965,39121
2114,24047,9008,14628,0.6083,0.3746,0.23369999999999996,5620,39123
2115,9483,2213,7086,0.7472,0.2333,0.5139,4873,39125
2116,16676,4098,12357,0.741,0.2457,0.49529999999999996,8259,39127
2117,28314,7304,20593,0.7273,0.258,0.46929999999999994,13289,39129
2118,12425,3110,9157,0.737,0.2503,0.48669999999999997,6047,39131
2119,83029,35661,45990,0.5539,0.4295,0.12439999999999996,10329,39133
2120,21840,4493,17022,0.7794,0.2057,0.5737,12529,39135
2121,19947,3195,16412,0.8228,0.1602,0.6626,13217,39137
2122,59974,17640,41472,0.6915,0.2941,0.39740000000000003,23832,39139
2123,33365,10557,22278,0.6677,0.3164,0.35129999999999995,11721,39141
2124,30128,10596,18896,0.6272,0.3517,0.27549999999999997,8300,39143
2125,32051,9080,22609,0.7054,0.2833,0.42210000000000003,13529,39145
2126,25849,8266,17086,0.661,0.3198,0.34120000000000006,8820,39147
2127,25294,4465,20422,0.8074,0.1765,0.6309,15957,39149
2128,190104,75904,111097,0.5844,0.3993,0.18510000000000004,35193,39151
2129,281282,151668,124833,0.4438,0.5392,-0.09540000000000004,-26835,39153
2130,101143,44519,55194,0.5457,0.4401,0.10559999999999997,10675,39155
2131,44085,12889,30458,0.6909,0.2924,0.39849999999999997,17569,39157
2132,33533,11141,21669,0.6462,0.3322,0.314,10528,39159
2133,14994,3067,11650,0.777,0.2045,0.5725,8583,39161
2134,6038,1331,4632,0.7671,0.2204,0.5467,3301,39163
2135,136437,46069,87988,0.6449,0.3376,0.3073,41919,39165
2136,32083,9243,22307,0.6953,0.2881,0.4072,13064,39167
2137,54281,16660,36759,0.6772,0.3069,0.3703,20099,39169
2138,18652,4842,13452,0.7212,0.2596,0.46159999999999995,8610,39171
2139,67606,30617,35757,0.5289,0.4529,0.07600000000000001,5140,39173
2140,11403,2733,8462,0.7421,0.2397,0.5024,5729,39175
2141,7108,1387,5585,0.7857,0.1951,0.5906,4198,40001
2142,2262,232,1978,0.8744,0.1026,0.7717999999999999,1746,40003
2143,5389,765,4557,0.8456,0.142,0.7036,3792,40005
2144,2178,190,1968,0.9036,0.0872,0.8164,1778,40007
2145,7948,1048,6767,0.8514,0.1319,0.7195,5719,40009
2146,3901,688,3136,0.8039,0.1764,0.6275,2448,40011
2147,15975,3323,12344,0.7727,0.208,0.5647000000000001,9021,40013
2148,9859,2670,7013,0.7113,0.2708,0.44050000000000006,4343,40015
2149,61940,16742,43550,0.7031,0.2703,0.43279999999999996,26808,40017
2150,19479,4470,14699,0.7546,0.2295,0.5251,10229,40019
2151,17713,6027,11223,0.6336,0.3402,0.29340000000000005,5196,40021
2152,5832,1082,4698,0.8056,0.1855,0.6201,3616,40023
2153,1054,70,970,0.9203,0.0664,0.8539,900,40025
2154,119772,49827,66677,0.5567,0.416,0.1407,16850,40027
2155,2524,374,2091,0.8284,0.1482,0.6802,1717,40029
2156,35631,13747,20905,0.5867,0.3858,0.20090000000000002,7158,40031
2157,2572,393,2117,0.8231,0.1528,0.6703000000000001,1724,40033
2158,6032,1217,4686,0.7769,0.2018,0.5751000000000001,3469,40035
2159,30506,6577,23294,0.7636,0.2156,0.5479999999999999,16717,40037
2160,10691,2369,8060,0.7539,0.2216,0.5323,5691,40039
2161,17246,3472,13557,0.7861,0.2013,0.5848,10085,40041
2162,2359,214,2124,0.9004,0.0907,0.8097,1910,40043
2163,1873,162,1688,0.9012,0.0865,0.8147,1526,40045
2164,22429,4919,16970,0.7566,0.2193,0.5373000000000001,12051,40047
2165,10921,1865,8878,0.8129,0.1708,0.6420999999999999,7013,40049
2166,23100,4144,18538,0.8025,0.1794,0.6231,14394,40051
2167,2226,280,1916,0.8607,0.1258,0.7349,1636,40053
2168,1973,328,1605,0.8135,0.1662,0.6473,1277,40055
2169,933,177,747,0.8006,0.1897,0.6109,570,40057
2170,1487,136,1327,0.8924,0.0915,0.8009,1191,40059
2171,5014,783,4165,0.8307,0.1562,0.6745,3382,40061
2172,4857,919,3875,0.7978,0.1892,0.6085999999999999,2956,40063
2173,8221,1646,6392,0.7775,0.2002,0.5772999999999999,4746,40065
2174,2385,319,2026,0.8495,0.1338,0.7157,1707,40067
2175,4251,738,3441,0.8095,0.1736,0.6359,2703,40069
2176,17250,4040,12834,0.744,0.2342,0.5098,8794,40071
2177,6465,854,5521,0.854,0.1321,0.7219,4667,40073
2178,3427,699,2673,0.78,0.204,0.5760000000000001,1974,40075
2179,4249,762,3437,0.8089,0.1793,0.6295999999999999,2675,40077
2180,18805,3299,15213,0.809,0.1754,0.6336,11914,40079
2181,14888,2609,12013,0.8069,0.1752,0.6316999999999999,9404,40081
2182,21573,5455,15608,0.7235,0.2529,0.4706,10153,40083
2183,4076,711,3305,0.8108,0.1744,0.6364,2594,40085
2184,19237,3582,15295,0.7951,0.1862,0.6089,11713,40087
2185,11466,1858,9485,0.8272,0.162,0.6652,7627,40089
2186,8335,2031,6172,0.7405,0.2437,0.4968,4141,40091
2187,3467,320,3084,0.8895,0.0923,0.7971999999999999,2764,40093
2188,6064,1100,4891,0.8066,0.1814,0.6252,3791,40095
2189,16626,3581,12749,0.7668,0.2154,0.5514,9168,40097
2190,5894,1156,4612,0.7825,0.1961,0.5864,3456,40099
2191,25081,8027,16526,0.6589,0.32,0.33890000000000003,8499,40101
2192,4938,1003,3821,0.7738,0.2031,0.5707,2818,40103
2193,4391,712,3610,0.8221,0.1621,0.66,2898,40105
2194,4038,896,3058,0.7573,0.2219,0.5354,2162,40107
2195,294757,141724,145050,0.4921,0.4808,0.011299999999999977,3326,40109
2196,14312,4357,9668,0.6755,0.3044,0.3711,5311,40111
2197,20537,6002,14121,0.6876,0.2922,0.3954,8119,40113
2198,11438,2686,8545,0.7471,0.2348,0.5123,5859,40115
2199,6786,1363,5267,0.7762,0.2009,0.5753,3904,40117
2200,29644,10904,17813,0.6009,0.3678,0.23309999999999997,6909,40119
2201,17923,3768,13851,0.7728,0.2102,0.5626,10083,40121
2202,15320,4117,10805,0.7053,0.2687,0.43660000000000004,6688,40123
2203,28185,7275,20240,0.7181,0.2581,0.45999999999999996,12965,40125
2204,4739,668,4016,0.8474,0.141,0.7064,3348,40127
2205,1834,168,1629,0.8882,0.0916,0.7966,1461,40129
2206,44555,9589,34031,0.7638,0.2152,0.5486,24442,40131
2207,8337,2150,6011,0.721,0.2579,0.46309999999999996,3861,40133
2208,15385,3035,12113,0.7873,0.1973,0.59,9078,40135
2209,19057,3154,15560,0.8165,0.1655,0.651,12406,40137
2210,5521,894,4505,0.816,0.1619,0.6540999999999999,3611,40139
2211,2708,597,2076,0.7666,0.2205,0.5460999999999999,1479,40141
2212,266691,108996,150574,0.5646,0.4087,0.15589999999999998,41578,40143
2213,35339,8464,26165,0.7404,0.2395,0.5008999999999999,17701,40145
2214,23501,5790,17076,0.7266,0.2464,0.4802,11286,40147
2215,4777,598,4086,0.8553,0.1252,0.7301,3488,40149
2216,3678,591,2993,0.8138,0.1607,0.6531,2402,40151
2217,7785,1005,6611,0.8492,0.1291,0.7201,5606,40153
2218,9932,2346,7352,0.7402,0.2362,0.504,5006,41001
2219,52796,35827,14878,0.2818,0.6786,-0.3968,-20949,41003
2220,257657,139043,110509,0.4289,0.5396,-0.11069999999999997,-28534,41005
2221,23907,12916,10218,0.4274,0.5402,-0.11280000000000001,-2698,41007
2222,32219,13835,17150,0.5323,0.4294,0.10289999999999999,3315,41009
2223,37074,14243,21829,0.5888,0.3842,0.2046,7586,41011
2224,15449,3801,11287,0.7306,0.2461,0.48450000000000004,7486,41013
2225,14926,6058,8484,0.5684,0.4059,0.16250000000000003,2426,41015
2226,125244,65962,55646,0.4443,0.5267,-0.08239999999999997,-10316,41017
2227,64345,19160,43298,0.6729,0.2978,0.37510000000000004,24138,41019
2228,1178,324,834,0.708,0.275,0.43299999999999994,510,41021
2229,4596,929,3545,0.7713,0.2021,0.5691999999999999,2616,41023
2230,4481,894,3475,0.7755,0.1995,0.576,2581,41025
2231,13092,8764,3955,0.3021,0.6695,-0.3674,-4809,41027
2232,127153,59478,63869,0.5023,0.4677,0.034599999999999964,4391,41029
2233,11912,4393,7189,0.6035,0.3688,0.23470000000000002,2796,41031
2234,51644,18451,31751,0.6148,0.3573,0.2575,13300,41033
2235,36726,10388,25308,0.6891,0.2829,0.40620000000000006,14920,41035
2236,4363,792,3470,0.7953,0.1815,0.6138,2678,41037
2237,222230,134366,80336,0.3615,0.6046,-0.24310000000000004,-54030,41039
2238,30727,17385,12460,0.4055,0.5658,-0.16029999999999994,-4925,41041
2239,72634,26512,43486,0.5987,0.365,0.23370000000000002,16974,41043
2240,11804,3260,8187,0.6936,0.2762,0.4174,4927,41045
2241,165519,80872,79002,0.4773,0.4886,-0.011299999999999977,-1870,41047
2242,5118,1371,3586,0.7007,0.2679,0.43279999999999996,2215,41049
2243,463659,367249,82995,0.179,0.7921,-0.6131,-284254,41051
2244,48295,22917,23732,0.4914,0.4746,0.01679999999999998,815,41053
2245,1208,260,921,0.7624,0.2152,0.5471999999999999,661,41055
2246,16887,8066,8354,0.4947,0.4776,0.01709999999999995,288,41057
2247,33038,10707,21270,0.6438,0.3241,0.31970000000000004,10563,41059
2248,14944,4254,10298,0.6891,0.2847,0.40440000000000004,6044,41061
2249,5149,1625,3404,0.6611,0.3156,0.34550000000000003,1779,41063
2250,14129,6604,7035,0.4979,0.4674,0.030500000000000027,431,41065
2251,320314,209940,99073,0.3093,0.6554,-0.34609999999999996,-110867,41067
2252,965,217,711,0.7368,0.2249,0.5119,494,41069
2253,58925,27174,29551,0.5015,0.4612,0.04029999999999995,2377,41071
2254,56716,18207,37523,0.6616,0.321,0.34059999999999996,19316,42001
2255,724860,430759,282913,0.3903,0.5943,-0.20400000000000007,-147846,42003
2256,36424,8457,27489,0.7547,0.2322,0.5225000000000001,19032,42005
2257,94396,38122,54759,0.5801,0.4038,0.17629999999999996,16637,42007
2258,27611,4367,23025,0.8339,0.1582,0.6757,18658,42009
2259,206550,93116,109926,0.5322,0.4508,0.08140000000000003,16810,42011
2260,63748,17636,45306,0.7107,0.2767,0.434,27670,42013
2261,30231,8046,21600,0.7145,0.2661,0.4484,13554,42015
2262,397301,204712,187367,0.4716,0.5153,-0.04369999999999996,-17345,42017
2263,113647,37508,74359,0.6543,0.33,0.3243,36851,42019
2264,70755,21730,48085,0.6796,0.3071,0.3725,26355,42021
2265,2440,634,1771,0.7258,0.2598,0.466,1137,42023
2266,33687,11212,21984,0.6526,0.3328,0.3198,10772,42025
2267,77884,40055,36372,0.467,0.5142,-0.047199999999999964,-3683,42027
2268,315729,182372,128565,0.4072,0.5776,-0.1704,-53807,42029
2269,19523,4678,14578,0.7467,0.2396,0.5071,9900,42031
2270,39496,9673,29203,0.7394,0.2449,0.49449999999999994,19530,42033
2271,17661,5502,11902,0.6739,0.3115,0.36240000000000006,6400,42035
2272,31281,10532,20098,0.6425,0.3367,0.30579999999999996,9566,42037
2273,42110,12924,28559,0.6782,0.3069,0.3713,15635,42039
2274,142195,62245,77212,0.543,0.4378,0.10520000000000002,14967,42041
2275,147902,78983,66408,0.449,0.534,-0.08500000000000002,-12575,42043
2276,329370,206709,118639,0.3602,0.6275,-0.2672999999999999,-88070,42045
2277,16946,4522,12140,0.7164,0.2668,0.44960000000000006,7618,42047
2278,137506,68286,66869,0.4863,0.4966,-0.010299999999999976,-1417,42049
2279,62254,20456,41243,0.6625,0.3286,0.3339,20787,42051
2280,2646,728,1882,0.7113,0.2751,0.43620000000000003,1154,42053
2281,81026,22422,57245,0.7065,0.2767,0.4298,34823,42055
2282,7990,1085,6824,0.8541,0.1358,0.7182999999999999,5739,42057
2283,17670,4911,12579,0.7119,0.2779,0.434,7668,42059
2284,22842,5445,17061,0.7469,0.2384,0.5085,11616,42061
2285,41289,12634,28089,0.6803,0.306,0.3743,15455,42063
2286,22864,4527,17960,0.7855,0.198,0.5874999999999999,13433,42065
2287,12072,2253,9649,0.7993,0.1866,0.6127,7396,42067
2288,115706,61991,52334,0.4523,0.5358,-0.08350000000000007,-9657,42069
2289,281365,115847,160209,0.5694,0.4117,0.1577,44362,42071
2290,46188,15978,29597,0.6408,0.3459,0.29490000000000005,13619,42073
2291,71861,23932,46731,0.6503,0.333,0.31729999999999997,22799,42075
2292,185656,98498,84418,0.4547,0.5305,-0.07579999999999998,-14080,42077
2293,153585,64873,86929,0.566,0.4224,0.14359999999999995,22056,42079
2294,59401,16971,41462,0.698,0.2857,0.41229999999999994,24491,42081
2295,19511,5098,14083,0.7218,0.2613,0.4605,8985,42083
2296,58117,21067,36143,0.6219,0.3625,0.2594,15076,42085
2297,21546,4603,16670,0.7737,0.2136,0.5601,12067,42087
2298,84041,44060,38726,0.4608,0.5243,-0.0635,-5334,42089
2299,510206,319511,185460,0.3635,0.6263,-0.2628,-134051,42091
2300,9817,3771,5844,0.5953,0.3841,0.21120000000000005,2073,42093
2301,171410,85087,83854,0.4892,0.4964,-0.007199999999999984,-1233,42095
2302,42383,12677,28952,0.6831,0.2991,0.38400000000000006,16275,42097
2303,24727,5950,18293,0.7398,0.2406,0.4992,12343,42099
2304,743953,604175,132870,0.1786,0.8121,-0.6335000000000001,-471305,42101
2305,32553,13019,19213,0.5902,0.3999,0.19029999999999997,6194,42103
2306,9063,1726,7239,0.7987,0.1904,0.6083,5513,42105
2307,70756,20727,48871,0.6907,0.2929,0.3978,28144,42107
2308,19181,4910,13983,0.729,0.256,0.473,9073,42109
2309,40628,8654,31466,0.7745,0.213,0.5615,22812,42111
2310,3598,921,2619,0.7279,0.256,0.4719,1698,42113
2311,21812,6236,15207,0.6972,0.2859,0.41130000000000005,8971,42115
2312,21127,4955,15742,0.7451,0.2345,0.5105999999999999,10787,42117
2313,20193,7475,12356,0.6119,0.3702,0.24170000000000003,4881,42119
2314,26599,7585,18569,0.6981,0.2851,0.41300000000000003,10984,42121
2315,20651,6066,14237,0.6894,0.2938,0.3956,8171,42123
2316,118748,45088,72080,0.607,0.3797,0.2273,26992,42125
2317,28148,9191,18637,0.6621,0.3265,0.3356,9446,42127
2318,205325,72192,130299,0.6346,0.3516,0.28300000000000003,58107,42129
2319,14859,4704,9936,0.6687,0.3166,0.35209999999999997,5232,42131
2320,239057,88114,146733,0.6138,0.3686,0.24520000000000003,58619,42133
2321,28411,18050,9745,0.343,0.6352,-0.29219999999999996,-8305,44001
2322,93087,49113,42001,0.4512,0.5276,-0.07639999999999997,-7112,44003
2323,46146,29486,15722,0.3407,0.6389,-0.2982,-13764,44005
2324,272670,165012,102551,0.3761,0.6052,-0.22909999999999997,-62461,44007
2325,76066,44549,29818,0.392,0.5857,-0.19369999999999998,-14731,44009
2326,12434,4101,8215,0.6607,0.3298,0.33089999999999997,4114,45001
2327,85187,32275,51589,0.6056,0.3789,0.2267,19314,45003
2328,3593,2718,835,0.2324,0.7565,-0.5241,-1883,45005
2329,96096,27169,67565,0.7031,0.2827,0.42039999999999994,40396,45007
2330,6482,4010,2417,0.3729,0.6186,-0.24570000000000003,-1593,45009
2331,10321,4720,5492,0.5321,0.4573,0.07480000000000003,772,45011
2332,97837,43419,53194,0.5437,0.4438,0.09989999999999999,9775,45013
2333,104453,45223,57397,0.5495,0.4329,0.11659999999999998,12174,45015
2334,8292,3905,4305,0.5192,0.471,0.04820000000000002,400,45017
2335,218853,121485,93297,0.4263,0.5551,-0.12880000000000003,-28188,45019
2336,25270,6983,18043,0.714,0.2763,0.4377,11060,45021
2337,15757,6941,8660,0.5496,0.4405,0.10909999999999997,1719,45023
2338,18876,7431,11297,0.5985,0.3937,0.20480000000000004,3866,45025
2339,16732,8250,8361,0.4997,0.493,0.006699999999999984,111,45027
2340,19283,8602,10440,0.5414,0.4461,0.0953,1838,45029
2341,32419,15220,16832,0.5192,0.4695,0.04970000000000002,1612,45031
2342,13101,6436,6582,0.5024,0.4913,0.011099999999999943,146,45033
2343,77273,33824,41913,0.5424,0.4377,0.10470000000000002,8089,45035
2344,13303,4953,8184,0.6152,0.3723,0.24289999999999995,3231,45037
2345,12136,7382,4625,0.3811,0.6083,-0.22719999999999996,-2757,45039
2346,64508,31153,32615,0.5056,0.4829,0.022700000000000053,1462,45041
2347,36669,15822,20487,0.5587,0.4315,0.12719999999999998,4665,45043
2348,258167,103030,150021,0.5811,0.3991,0.18199999999999994,46991,45045
2349,32006,12145,19431,0.6071,0.3795,0.22759999999999997,7286,45047
2350,9304,5323,3906,0.4198,0.5721,-0.15230000000000005,-1417,45049
2351,179732,59180,118821,0.6611,0.3292,0.33190000000000003,59641,45051
2352,14395,7185,7078,0.4917,0.4992,-0.007499999999999951,-107,45053
2353,33631,12699,20471,0.6087,0.3776,0.23110000000000003,7772,45055
2354,49872,18937,30312,0.6078,0.3797,0.22810000000000002,11375,45057
2355,30489,10159,20004,0.6561,0.3332,0.3229,9845,45059
2356,8430,5329,3008,0.3568,0.6321,-0.2753,-2321,45061
2357,144575,49301,92817,0.642,0.341,0.301,43516,45063
2358,5697,2687,2958,0.5192,0.4717,0.04749999999999999,271,45065
2359,14704,8872,5711,0.3884,0.6034,-0.21500000000000002,-3161,45067
2360,11445,6290,5044,0.4407,0.5495,-0.10880000000000001,-1246,45069
2361,18631,6958,11443,0.6142,0.3735,0.24069999999999997,4485,45071
2362,40665,10414,29698,0.7303,0.2561,0.47419999999999995,19284,45073
2363,41209,27295,13603,0.3301,0.6624,-0.3323,-13692,45075
2364,57547,13645,42907,0.7456,0.2371,0.5085000000000001,29262,45077
2365,193795,132570,58313,0.3009,0.684,-0.38310000000000005,-74257,45079
2366,9274,2963,6210,0.6696,0.3195,0.35009999999999997,3247,45081
2367,148650,52926,93560,0.6294,0.356,0.2734,40634,45083
2368,48917,27379,21000,0.4293,0.5597,-0.13039999999999996,-6379,45085
2369,13256,4935,8183,0.6173,0.3723,0.24499999999999994,3248,45087
2370,15984,10289,5532,0.3461,0.6437,-0.29760000000000003,-4757,45089
2371,144048,59008,82727,0.5743,0.4096,0.1647,23719,45091
2372,1405,317,1052,0.7488,0.2256,0.5232,735,46003
2373,7081,2107,4808,0.679,0.2976,0.3814000000000001,2701,46005
2374,1183,466,694,0.5866,0.3939,0.19270000000000004,228,46007
2375,3001,721,2235,0.7448,0.2403,0.5045,1514,46009
2376,14567,6110,8000,0.5492,0.4194,0.12980000000000003,1890,46011
2377,17546,6538,10580,0.603,0.3726,0.2304,4042,46013
2378,2490,673,1750,0.7028,0.2703,0.4325,1077,46015
2379,549,352,183,0.3333,0.6412,-0.3079,-169,46017
2380,4802,939,3731,0.777,0.1955,0.5815,2792,46019
2381,873,117,747,0.8557,0.134,0.7217,630,46021
2382,3783,1177,2552,0.6746,0.3111,0.3635,1375,46023
2383,1850,437,1373,0.7422,0.2362,0.506,936,46025
2384,5698,3083,2456,0.431,0.5411,-0.11010000000000003,-627,46027
2385,13162,3837,8958,0.6806,0.2915,0.3891,5121,46029
2386,1283,622,647,0.5043,0.4848,0.019499999999999962,25,46031
2387,5494,1522,3852,0.7011,0.277,0.4240999999999999,2330,46033
2388,8455,2648,5613,0.6639,0.3132,0.35070000000000007,2965,46035
2389,2964,1052,1869,0.6306,0.3549,0.27570000000000006,817,46037
2390,2350,609,1699,0.723,0.2591,0.4639,1090,46039
2391,1966,1131,790,0.4018,0.5753,-0.17350000000000004,-341,46041
2392,1707,216,1468,0.86,0.1265,0.7335,1252,46043
2393,1985,417,1538,0.7748,0.2101,0.5647,1121,46045
2394,4042,1053,2878,0.712,0.2605,0.45149999999999996,1825,46047
2395,1182,198,964,0.8156,0.1675,0.6481,766,46049
2396,3745,1056,2618,0.6991,0.282,0.4171000000000001,1562,46051
2397,2258,455,1771,0.7843,0.2015,0.5828,1316,46053
2398,1137,105,1026,0.9024,0.0923,0.8101,921,46055
2399,3083,647,2372,0.7694,0.2099,0.5595,1725,46057
2400,1836,373,1433,0.7805,0.2032,0.5772999999999999,1060,46059
2401,2388,557,1793,0.7508,0.2332,0.5176000000000001,1236,46061
2402,813,49,748,0.92,0.0603,0.8597,699,46063
2403,8724,2953,5522,0.633,0.3385,0.2945,2569,46065
2404,3767,762,2944,0.7815,0.2023,0.5791999999999999,2182,46067
2405,710,136,564,0.7944,0.1915,0.6029,428,46069
2406,1115,359,738,0.6619,0.322,0.33990000000000004,379,46071
2407,1006,270,721,0.7167,0.2684,0.4483,451,46073
2408,599,90,498,0.8314,0.1503,0.6811,408,46075
2409,2779,819,1904,0.6851,0.2947,0.3904,1085,46077
2410,5873,2068,3681,0.6268,0.3521,0.2747,1613,46079
2411,13828,4537,8753,0.633,0.3281,0.3049,4216,46081
2412,32398,11981,19617,0.6055,0.3698,0.23570000000000002,7636,46083
2413,1597,525,1042,0.6525,0.3287,0.3238,517,46085
2414,2900,769,2068,0.7131,0.2652,0.44789999999999996,1299,46087
2415,1324,222,1075,0.8119,0.1677,0.6442,853,46089
2416,2178,858,1287,0.5909,0.3939,0.197,429,46091
2417,13670,3285,9875,0.7224,0.2403,0.48210000000000003,6590,46093
2418,769,298,449,0.5839,0.3875,0.19639999999999996,151,46095
2419,1138,320,787,0.6916,0.2812,0.4104,467,46097
2420,92330,40482,49249,0.5334,0.4385,0.09489999999999998,8767,46099
2421,3206,1179,1951,0.6085,0.3677,0.24080000000000001,772,46101
2422,57518,20606,35063,0.6096,0.3583,0.2513,14457,46103
2423,1669,239,1401,0.8394,0.1432,0.6962,1162,46105
2424,1380,227,1139,0.8254,0.1645,0.6609,912,46107
2425,4307,1828,2404,0.5582,0.4244,0.13380000000000003,576,46109
2426,1185,257,905,0.7637,0.2169,0.5468000000000001,648,46111
2427,3163,998,2104,0.6652,0.3155,0.3497,1106,46115
2428,1652,421,1203,0.7282,0.2548,0.47339999999999993,782,46117
2429,930,185,726,0.7806,0.1989,0.5817,541,46119
2430,2539,1963,532,0.2095,0.7731,-0.5636,-1431,46121
2431,2696,495,2161,0.8016,0.1836,0.618,1666,46123
2432,4548,1139,3290,0.7234,0.2504,0.47300000000000003,2151,46125
2433,8854,2725,5944,0.6713,0.3077,0.36360000000000003,3219,46127
2434,2580,565,1966,0.762,0.219,0.543,1401,46129
2435,10899,4016,6581,0.6038,0.3684,0.2354,2565,46135
2436,906,481,404,0.4459,0.5309,-0.08500000000000002,-77,46137
2437,35569,11741,23184,0.6518,0.3301,0.32170000000000004,11443,47001
2438,19088,4453,14354,0.752,0.2333,0.5186999999999999,9901,47003
2439,7260,1529,5668,0.7807,0.2106,0.5700999999999999,4139,47005
2440,5758,971,4725,0.8206,0.1686,0.652,3754,47007
2441,66604,17932,47369,0.7112,0.2692,0.44200000000000006,29437,47009
2442,45862,9851,35204,0.7676,0.2148,0.5528,25353,47011
2443,14932,2441,12331,0.8258,0.1635,0.6623,9890,47013
2444,6557,1261,5190,0.7915,0.1923,0.5992,3929,47015
2445,11905,2559,9205,0.7732,0.215,0.5582,6646,47017
2446,24492,4529,19584,0.7996,0.1849,0.6147,15055,47019
2447,20261,5514,14438,0.7126,0.2722,0.4404,8924,47021
2448,7584,1412,5952,0.7848,0.1862,0.5986,4540,47023
2449,12944,2202,10604,0.8192,0.1701,0.6491,8402,47025
2450,3506,735,2733,0.7795,0.2096,0.5699,1998,47027
2451,14859,2533,12162,0.8185,0.1705,0.648,9629,47029
2452,24281,5705,17883,0.7365,0.2349,0.5016,12178,47031
2453,6114,1382,4673,0.7643,0.226,0.5383,3291,47033
2454,32279,6728,25168,0.7797,0.2084,0.5712999999999999,18440,47035
2455,309697,199703,100218,0.3236,0.6449,-0.32130000000000003,-99485,47037
2456,5241,904,4229,0.8069,0.1725,0.6344,3325,47039
2457,8513,1750,6672,0.7837,0.2056,0.5781,4922,47041
2458,24322,6106,17643,0.7254,0.251,0.47440000000000004,11537,47043
2459,15079,3158,11768,0.7804,0.2094,0.571,8610,47045
2460,22986,7027,15690,0.6826,0.3057,0.37689999999999996,8663,47047
2461,8729,1214,7441,0.8524,0.1391,0.7133,6227,47049
2462,19131,4864,13987,0.7311,0.2542,0.4769,9123,47051
2463,22334,5771,16259,0.728,0.2584,0.46959999999999996,10488,47053
2464,13204,3298,9784,0.741,0.2498,0.49119999999999997,6486,47055
2465,10134,1467,8565,0.8452,0.1448,0.7003999999999999,7098,47057
2466,28087,5199,22259,0.7925,0.1851,0.6073999999999999,17060,47059
2467,5855,988,4802,0.8202,0.1687,0.6515000000000001,3814,47061
2468,24631,5500,18811,0.7637,0.2233,0.5404,13311,47063
2469,171109,75522,92108,0.5383,0.4414,0.09689999999999999,16586,47065
2470,2744,362,2372,0.8644,0.1319,0.7324999999999999,2010,47067
2471,10063,4180,5760,0.5724,0.4154,0.15700000000000003,1580,47069
2472,11538,1775,9559,0.8285,0.1538,0.6747000000000001,7784,47071
2473,24824,4083,20405,0.822,0.1645,0.6575,16322,47073
2474,7439,4012,3343,0.4494,0.5393,-0.08989999999999998,-669,47075
2475,12019,2092,9797,0.8151,0.174,0.6411,7705,47077
2476,15048,3548,11239,0.7469,0.2358,0.5111,7691,47079
2477,9833,2130,7577,0.7706,0.2166,0.5539999999999999,5447,47081
2478,3686,871,2718,0.7374,0.2363,0.5011000000000001,1847,47083
2479,8236,2017,6120,0.7431,0.2449,0.4982,4103,47085
2480,5323,1135,4118,0.7736,0.2132,0.5604,2983,47087
2481,23615,4654,18651,0.7898,0.1971,0.5927,13997,47089
2482,7801,1246,6468,0.8291,0.1597,0.6694,5222,47091
2483,220542,91422,124540,0.5647,0.4145,0.1502,33118,47093
2484,2034,526,1492,0.7335,0.2586,0.47490000000000004,966,47095
2485,8965,3193,5674,0.6329,0.3562,0.2767,2481,47097
2486,18718,3195,15334,0.8192,0.1707,0.6485000000000001,12139,47099
2487,5609,1072,4474,0.7976,0.1911,0.6065,3402,47101
2488,15609,2919,12281,0.7868,0.187,0.5998000000000001,9362,47103
2489,29346,6948,21713,0.7399,0.2368,0.5031,14765,47105
2490,22845,4361,18198,0.7966,0.1909,0.6057,13837,47107
2491,11275,1943,9093,0.8065,0.1723,0.6342,7150,47109
2492,9487,1307,8096,0.8534,0.1378,0.7156,6789,47111
2493,42947,18390,23943,0.5575,0.4282,0.12929999999999997,5553,47113
2494,13255,3177,9911,0.7477,0.2397,0.508,6734,47115
2495,14879,3605,11043,0.7422,0.2423,0.4999,7438,47117
2496,46655,14418,31464,0.6744,0.309,0.3654,17046,47119
2497,5532,1008,4467,0.8075,0.1822,0.6253,3459,47121
2498,20797,3764,16783,0.807,0.181,0.6260000000000001,13019,47123
2499,76759,32472,42187,0.5496,0.423,0.1266,9715,47125
2500,3539,573,2888,0.816,0.1619,0.6540999999999999,2315,47127
2501,8228,1167,6930,0.8422,0.1418,0.7003999999999999,5763,47129
2502,13521,2589,10790,0.798,0.1915,0.6065,8201,47131
2503,10037,2033,7918,0.7889,0.2026,0.5863,5885,47133
2504,3428,615,2775,0.8095,0.1794,0.6301,2160,47135
2505,2931,525,2381,0.8124,0.1791,0.6333,1856,47137
2506,8360,1492,6792,0.8124,0.1785,0.6339,5300,47139
2507,33591,9185,23759,0.7073,0.2734,0.43390000000000006,14574,47141
2508,13637,2369,11050,0.8103,0.1737,0.6366,8681,47143
2509,25916,6043,19230,0.742,0.2332,0.5088,13187,47145
2510,33717,8692,24536,0.7277,0.2578,0.46990000000000004,15844,47147
2511,143881,59341,81480,0.5663,0.4124,0.15390000000000004,22139,47149
2512,9052,986,8004,0.8842,0.1089,0.7753,7018,47151
2513,7252,1298,5855,0.8074,0.179,0.6284000000000001,4557,47153
2514,43535,8721,33783,0.776,0.2003,0.5757,25062,47155
2515,382034,246105,129815,0.3398,0.6442,-0.3044,-116290,47157
2516,9051,1802,7136,0.7884,0.1991,0.5892999999999999,5334,47159
2517,6296,1232,4950,0.7862,0.1957,0.5905,3718,47161
2518,74361,17272,55860,0.7512,0.2323,0.5188999999999999,38588,47163
2519,92634,27680,63454,0.685,0.2988,0.38620000000000004,35774,47165
2520,27310,6837,20070,0.7349,0.2504,0.4845,13233,47167
2521,3998,1012,2936,0.7344,0.2531,0.48130000000000006,1924,47169
2522,8307,1615,6599,0.7944,0.1944,0.6,4984,47171
2523,8123,1249,6803,0.8375,0.1538,0.6837,5554,47173
2524,2921,544,2342,0.8018,0.1862,0.6155999999999999,1798,47175
2525,16009,3924,11850,0.7402,0.2451,0.4951,7926,47177
2526,60202,18638,40444,0.6718,0.3096,0.36219999999999997,21806,47179
2527,6669,820,5795,0.8689,0.123,0.7459,4975,47181
2528,13735,3020,10396,0.7569,0.2199,0.537,7376,47183
2529,11895,2143,9606,0.8076,0.1802,0.6274,7463,47185
2530,139018,50161,86469,0.622,0.3608,0.2612,36308,47187
2531,74325,22254,50296,0.6767,0.2994,0.37729999999999997,28042,47189
2532,19226,3955,15110,0.7859,0.2057,0.5802,11155,48001
2533,5863,850,4943,0.8431,0.145,0.6980999999999999,4093,48003
2534,34573,9143,25076,0.7253,0.2644,0.4608999999999999,15933,48005
2535,12291,2916,9239,0.7517,0.2373,0.5144,6323,48007
2536,4796,446,4300,0.8966,0.093,0.8036,3854,48009
2537,1112,75,1035,0.9308,0.0674,0.8634,960,48011
2538,18117,5876,12039,0.6645,0.3243,0.3402,6163,48013
2539,14554,2951,11447,0.7865,0.2028,0.5837,8496,48015
2540,1860,409,1434,0.771,0.2199,0.5511,1025,48017
2541,12714,2505,10057,0.791,0.197,0.5940000000000001,7552,48019
2542,36662,15474,20516,0.5596,0.422,0.1376,5042,48021
2543,1702,183,1494,0.8778,0.1075,0.7703,1311,48023
2544,9420,3288,6006,0.6376,0.349,0.28859999999999997,2718,48025
2545,127379,57014,67893,0.533,0.4476,0.08540000000000003,10879,48027
2546,770774,448452,308618,0.4004,0.5818,-0.1814,-139834,48029
2547,7441,1911,5443,0.7315,0.2568,0.47470000000000007,3532,48031
2548,416,16,397,0.9543,0.0385,0.9158000000000001,381,48033
2549,9126,1561,7469,0.8184,0.171,0.6474,5908,48035
2550,38262,10747,27116,0.7087,0.2809,0.4278,16369,48037
2551,154984,62228,90433,0.5835,0.4015,0.182,28205,48039
2552,85057,35349,47530,0.5588,0.4156,0.14319999999999994,12181,48041
2553,4822,2258,2461,0.5104,0.4683,0.04209999999999997,203,48043
2554,725,78,639,0.8814,0.1076,0.7737999999999999,561,48045
2555,2484,1470,998,0.4018,0.5918,-0.19,-472,48047
2556,15969,2107,13698,0.8578,0.1319,0.7259,11591,48049
2557,8608,1788,6743,0.7833,0.2077,0.5756,4955,48051
2558,24716,5639,18767,0.7593,0.2281,0.5312,13128,48053
2559,14972,6672,8031,0.5364,0.4456,0.09079999999999999,1359,48055
2560,7857,2148,5641,0.718,0.2734,0.4446,3493,48057
2561,6832,734,6012,0.88,0.1074,0.7726,5278,48059
2562,114187,64063,49032,0.4294,0.5611,-0.13170000000000004,-15031,48061
2563,5060,1394,3626,0.7166,0.2755,0.4411,2232,48063
2564,3122,297,2779,0.8901,0.0951,0.795,2482,48065
2565,13927,2795,11033,0.7922,0.2007,0.5915,8238,48067
2566,2083,466,1602,0.7691,0.2237,0.5454,1136,48069
2567,21651,3997,17353,0.8015,0.1846,0.6169,13356,48071
2568,19508,4210,15101,0.7741,0.2158,0.5583,10891,48073
2569,2279,310,1943,0.8526,0.136,0.7166,1633,48075
2570,5744,614,5069,0.8825,0.1069,0.7756,4455,48077
2571,1000,177,809,0.809,0.177,0.6320000000000001,632,48079
2572,1779,178,1586,0.8915,0.1001,0.7914,1408,48081
2573,4124,451,3641,0.8829,0.1094,0.7735000000000001,3190,48083
2574,490891,230945,252318,0.514,0.4705,0.04350000000000004,21373,48085
2575,1218,155,1048,0.8604,0.1273,0.7331000000000001,893,48087
2576,9975,2420,7472,0.7491,0.2426,0.5065,5052,48089
2577,88892,24826,62740,0.7058,0.2793,0.4265,37914,48091
2578,6086,853,5177,0.8506,0.1402,0.7104,4324,48093
2579,1268,197,1058,0.8344,0.1554,0.679,861,48095
2580,18996,3210,15596,0.821,0.169,0.6519999999999999,12386,48097
2581,23494,7565,15438,0.6571,0.322,0.3351,7873,48099
2582,662,113,540,0.8157,0.1707,0.645,427,48101
2583,1503,241,1247,0.8297,0.1603,0.6694,1006,48103
2584,1574,344,1220,0.7751,0.2186,0.5565,876,48105
2585,1953,527,1396,0.7148,0.2698,0.445,869,48107
2586,864,438,415,0.4803,0.5069,-0.026600000000000013,-23,48109
2587,1609,197,1389,0.8633,0.1224,0.7409,1192,48111
2588,919389,598576,307076,0.334,0.651,-0.317,-291500,48113
2589,3789,808,2951,0.7788,0.2132,0.5656000000000001,2143,48115
2590,4610,1264,3294,0.7145,0.2742,0.4403,2030,48117
2591,2592,403,2162,0.8341,0.1555,0.6786,1759,48119
2592,417960,188695,222480,0.5323,0.4515,0.08079999999999998,33785,48121
2593,8118,1494,6567,0.8089,0.184,0.6249,5073,48123
2594,988,130,853,0.8634,0.1316,0.7318,723,48125
2595,3666,2264,1384,0.3775,0.6176,-0.24010000000000004,-880,48127
2596,1648,198,1438,0.8726,0.1201,0.7525000000000001,1240,48129
2597,5053,2575,2443,0.4835,0.5096,-0.026100000000000068,-132,48131
2598,8293,983,7237,0.8727,0.1185,0.7542,6254,48133
2599,44589,11367,32697,0.7333,0.2549,0.47839999999999994,21330,48135
2600,1066,168,893,0.8377,0.1576,0.6801,725,48137
2601,85494,27565,56717,0.6634,0.3224,0.34099999999999997,29152,48139
2602,266701,178126,84331,0.3162,0.6678,-0.35159999999999997,-93795,48141
2603,16856,2916,13684,0.8118,0.173,0.6388,10768,48143
2604,6133,1899,4177,0.6811,0.3096,0.37150000000000005,2278,48145
2605,15007,2655,12171,0.811,0.1769,0.6341000000000001,9516,48147
2606,12940,2661,10171,0.786,0.2056,0.5804,7510,48149
2607,1826,352,1448,0.793,0.1928,0.6002000000000001,1096,48151
2608,2039,438,1584,0.7769,0.2148,0.5621,1146,48153
2609,551,99,445,0.8076,0.1797,0.6279,346,48155
2610,357475,195552,157718,0.4412,0.547,-0.10580000000000006,-37834,48157
2611,5009,804,4161,0.8307,0.1605,0.6702,3357,48159
2612,8712,1635,6991,0.8025,0.1877,0.6148,5356,48161
2613,5279,2422,2823,0.5348,0.4588,0.07600000000000007,401,48163
2614,5996,576,5355,0.8931,0.0961,0.797,4779,48165
2615,155071,58842,93911,0.6056,0.3795,0.22610000000000002,35069,48167
2616,1653,231,1413,0.8548,0.1397,0.7151000000000001,1182,48169
2617,15851,3176,12514,0.7895,0.2004,0.5891,9338,48171
2618,653,39,611,0.9357,0.0597,0.876,572,48173
2619,3995,877,3085,0.7722,0.2195,0.5527,2208,48175
2620,7648,1948,5627,0.7357,0.2547,0.48100000000000004,3679,48177
2621,7782,829,6840,0.879,0.1065,0.7725,6011,48179
2622,59471,14506,44163,0.7426,0.2439,0.49870000000000003,29657,48181
2623,47981,14796,32493,0.6772,0.3084,0.3688,17697,48183
2624,12414,2833,9432,0.7598,0.2282,0.5316000000000001,6599,48185
2625,77625,28805,47553,0.6126,0.3711,0.24150000000000005,18748,48187
2626,9586,2279,7177,0.7487,0.2377,0.511,4898,48189
2627,1169,168,995,0.8512,0.1437,0.7075,827,48191
2628,4351,641,3616,0.8311,0.1473,0.6838,2975,48193
2629,2047,166,1849,0.9033,0.0811,0.8222,1683,48195
2630,1580,241,1330,0.8418,0.1525,0.6893,1089,48197
2631,27636,3474,23858,0.8633,0.1257,0.7375999999999999,20384,48199
2632,1640820,918193,700630,0.427,0.5596,-0.1326,-217563,48201
2633,29719,7908,21466,0.7223,0.2661,0.45620000000000005,13558,48203
2634,2078,195,1868,0.8989,0.0938,0.8051,1673,48205
2635,2214,353,1840,0.8311,0.1594,0.6717,1487,48207
2636,109383,59524,47680,0.4359,0.5441,-0.10820000000000002,-11844,48209
2637,1720,206,1486,0.864,0.1198,0.7442,1280,48211
2638,36316,7060,28911,0.7961,0.1944,0.6017,21851,48213
2639,220905,128199,90527,0.4098,0.5804,-0.17060000000000003,-37672,48215
2640,14932,2860,11926,0.7987,0.1915,0.6072,9066,48217
2641,8100,1482,6536,0.8069,0.183,0.6238999999999999,5054,48219
2642,32542,5648,26496,0.8142,0.1736,0.6406000000000001,20848,48221
2643,15941,3046,12719,0.7979,0.1911,0.6068,9673,48223
2644,9439,2314,7060,0.748,0.2452,0.5028,4746,48225
2645,10242,2069,8054,0.7864,0.202,0.5844,5985,48227
2646,1165,371,779,0.6687,0.3185,0.35019999999999996,408,48229
2647,38596,8906,29163,0.7556,0.2307,0.5249,20257,48231
2648,8773,965,7681,0.8755,0.11,0.7655,6716,48233
2649,889,120,759,0.8538,0.135,0.7188,639,48235
2650,3782,331,3418,0.9038,0.0875,0.8163,3087,48237
2651,6353,1033,5231,0.8234,0.1626,0.6608,4198,48239
2652,15611,2954,12542,0.8034,0.1892,0.6142,9588,48241
2653,1305,501,784,0.6008,0.3839,0.21689999999999998,283,48243
2654,94761,46073,47570,0.502,0.4862,0.01579999999999998,1497,48245
2655,2036,1197,833,0.4091,0.5879,-0.17879999999999996,-364,48247
2656,13670,6119,7453,0.5452,0.4477,0.09750000000000003,1334,48249
2657,72021,16464,54628,0.7585,0.2286,0.5298999999999999,38164,48251
2658,6741,999,5660,0.8396,0.1482,0.6914,4661,48253
2659,5252,1234,3968,0.7555,0.235,0.5205,2734,48255
2660,56714,18405,37624,0.6634,0.3245,0.3389,19219,48257
2661,26453,6020,20083,0.7592,0.2276,0.5316,14063,48259
2662,194,65,127,0.6546,0.3351,0.31949999999999995,62,48261
2663,462,47,411,0.8896,0.1017,0.7878999999999999,364,48263
2664,27746,6524,20879,0.7525,0.2351,0.5174,14355,48265
2665,2292,284,1987,0.8669,0.1239,0.743,1703,48267
2666,159,8,151,0.9497,0.0503,0.8994,143,48269
2667,1603,446,1144,0.7137,0.2782,0.4355,698,48271
2668,10945,5314,5504,0.5029,0.4856,0.017300000000000038,190,48273
2669,1456,265,1180,0.8104,0.182,0.6284000000000001,915,48275
2670,21443,4458,16760,0.7816,0.2079,0.5737,12302,48277
2671,4410,840,3521,0.7984,0.1905,0.6079,2681,48279
2672,10399,2144,8086,0.7776,0.2062,0.5713999999999999,5942,48281
2673,2406,1052,1335,0.5549,0.4372,0.11769999999999997,283,48283
2674,10197,1333,8804,0.8634,0.1307,0.7326999999999999,7471,48285
2675,8087,1750,6255,0.7735,0.2164,0.5570999999999999,4505,48287
2676,8674,1072,7523,0.8673,0.1236,0.7436999999999999,6451,48289
2677,29333,5785,23302,0.7944,0.1972,0.5972,17517,48291
2678,9094,2213,6789,0.7465,0.2433,0.5032000000000001,4576,48293
2679,1353,131,1205,0.8906,0.0968,0.7938,1074,48295
2680,5054,819,4199,0.8308,0.162,0.6688,3380,48297
2681,12660,2465,10079,0.7961,0.1947,0.6014,7614,48299
2682,66,4,60,0.9091,0.0606,0.8485,56,48301
2683,120823,40017,78861,0.6527,0.3312,0.32149999999999995,38844,48303
2684,2293,428,1853,0.8081,0.1867,0.6214000000000001,1425,48305
2685,3436,490,2904,0.8452,0.1426,0.7025999999999999,2414,48307
2686,97868,36688,59543,0.6084,0.3749,0.23350000000000004,22855,48309
2687,516,53,460,0.8915,0.1027,0.7888,407,48311
2688,5298,1088,4169,0.7869,0.2054,0.5815,3081,48313
2689,4864,1339,3470,0.7134,0.2753,0.43810000000000004,2131,48315
2690,2160,288,1857,0.8597,0.1333,0.7264,1569,48317
2691,2474,457,1991,0.8048,0.1847,0.6201,1534,48319
2692,13727,3733,9845,0.7172,0.2719,0.4453,6112,48321
2693,15346,8332,6881,0.4484,0.5429,-0.09450000000000003,-1451,48323
2694,22656,6773,15642,0.6904,0.2989,0.3915,8869,48325
2695,1028,197,823,0.8006,0.1916,0.609,626,48327
2696,58862,12329,45624,0.7751,0.2095,0.5656,33295,48329
2697,10578,2496,7984,0.7548,0.236,0.5188,5488,48331
2698,2505,271,2217,0.885,0.1082,0.7768,1946,48333
2699,2579,397,2170,0.8414,0.1539,0.6875,1773,48335
2700,9819,1097,8615,0.8774,0.1117,0.7656999999999999,7518,48337
2701,271528,74377,193382,0.7122,0.2739,0.4383000000000001,119005,48339
2702,5508,1062,4359,0.7914,0.1928,0.5986,3297,48341
2703,5587,1669,3872,0.693,0.2987,0.39429999999999993,2203,48343
2704,652,46,604,0.9264,0.0706,0.8558,558,48345
2705,26785,9000,17378,0.6488,0.336,0.3128,8378,48347
2706,19124,5101,13800,0.7216,0.2667,0.4549,8699,48349
2707,6094,1173,4882,0.8011,0.1925,0.6086,3709,48351
2708,5357,1162,4131,0.7711,0.2169,0.5542,2969,48353
2709,127324,60925,64617,0.5075,0.4785,0.02899999999999997,3692,48355
2710,3156,302,2812,0.891,0.0957,0.7953,2510,48357
2711,1009,81,917,0.9088,0.0803,0.8285,836,48359
2712,35992,6357,29186,0.8109,0.1766,0.6343,22829,48361
2713,12490,2178,10179,0.815,0.1744,0.6406,8001,48363
2714,11451,2057,9326,0.8144,0.1796,0.6348,7269,48365
2715,76129,13017,62045,0.815,0.171,0.6439999999999999,49028,48367
2716,2650,488,2135,0.8057,0.1842,0.6214999999999999,1647,48369
2717,4668,1382,3215,0.6887,0.2961,0.3926,1833,48371
2718,24187,5387,18573,0.7679,0.2227,0.5452,13186,48373
2719,33338,9921,22820,0.6845,0.2976,0.3869,12899,48375
2720,2217,1463,721,0.3252,0.6599,-0.33470000000000005,-742,48377
2721,6053,842,5155,0.8516,0.1391,0.7125,4313,48379
2722,64675,12802,50796,0.7854,0.1979,0.5875,37994,48381
2723,1124,172,942,0.8381,0.153,0.6850999999999999,770,48383
2724,1982,320,1643,0.829,0.1615,0.6675,1323,48385
2725,5806,1246,4517,0.778,0.2146,0.5634,3271,48387
2726,3689,1395,2254,0.611,0.3782,0.2328,859,48389
2727,3366,1108,2210,0.6566,0.3292,0.32739999999999997,1102,48391
2728,550,17,529,0.9618,0.0309,0.9309,512,48393
2729,8099,2374,5646,0.6971,0.2931,0.404,3272,48395
2730,53890,16412,36726,0.6815,0.3045,0.377,20314,48397
2731,4409,552,3807,0.8635,0.1252,0.7383000000000001,3255,48399
2732,21378,4629,16534,0.7734,0.2165,0.5569,11905,48401
2733,5491,669,4784,0.8712,0.1218,0.7494,4115,48403
2734,4002,980,3007,0.7514,0.2449,0.5065,2027,48405
2735,12640,2337,10161,0.8039,0.1849,0.619,7824,48407
2736,25891,8988,16516,0.6379,0.3471,0.2908,7528,48409
2737,2602,287,2308,0.887,0.1103,0.7767000000000001,2021,48411
2738,1159,211,940,0.811,0.1821,0.6289,729,48413
2739,5870,818,4983,0.8489,0.1394,0.7095,4165,48415
2740,1628,130,1484,0.9115,0.0799,0.8316,1354,48417
2741,10087,2068,7975,0.7906,0.205,0.5856,5907,48419
2742,992,91,886,0.8931,0.0917,0.8014,795,48421
2743,100087,29615,69080,0.6902,0.2959,0.39430000000000004,39465,48423
2744,4947,768,4105,0.8298,0.1552,0.6746,3337,48425
2745,17524,9123,8247,0.4706,0.5206,-0.04999999999999993,-876,48427
2746,3800,397,3385,0.8908,0.1045,0.7863,2988,48429
2747,639,51,584,0.9139,0.0798,0.8341000000000001,533,48431
2748,736,116,615,0.8356,0.1576,0.678,499,48433
2749,1557,322,1222,0.7848,0.2068,0.5780000000000001,900,48435
2750,2355,478,1845,0.7834,0.203,0.5804,1367,48437
2751,834673,411567,409741,0.4909,0.4931,-0.0021999999999999797,-1826,48439
2752,55133,14588,39547,0.7173,0.2646,0.45270000000000005,24959,48441
2753,458,119,334,0.7293,0.2598,0.4695,215,48443
2754,3612,757,2812,0.7785,0.2096,0.5689,2055,48445
2755,894,82,806,0.9016,0.0917,0.8099,724,48447
2756,10542,2856,7570,0.7181,0.2709,0.4472,4714,48449
2757,45212,12239,32313,0.7147,0.2707,0.444,20074,48451
2758,608589,435860,161337,0.2651,0.7162,-0.45109999999999995,-274523,48453
2759,6938,1323,5579,0.8041,0.1907,0.6134000000000001,4256,48455
2760,9660,1403,8194,0.8482,0.1452,0.703,6791,48457
2761,18892,2877,15809,0.8368,0.1523,0.6845,12932,48459
2762,1368,170,1178,0.8611,0.1243,0.7368,1008,48461
2763,10343,4073,6174,0.5969,0.3938,0.2031,2101,48463
2764,15281,6771,8284,0.5421,0.4431,0.09900000000000003,1513,48465
2765,26029,3516,22270,0.8556,0.1351,0.7205,18754,48467
2766,34189,10380,23358,0.6832,0.3036,0.37960000000000005,12978,48469
2767,23610,7884,15375,0.6512,0.3339,0.3173,7491,48471
2768,22732,8191,14260,0.6273,0.3603,0.26699999999999996,6069,48473
2769,4060,764,3241,0.7983,0.1882,0.6101,2477,48475
2770,17427,4261,12959,0.7436,0.2445,0.49910000000000004,8698,48477
2771,68405,41820,25898,0.3786,0.6114,-0.23280000000000006,-15922,48479
2772,16762,4694,11926,0.7115,0.2801,0.4314,7232,48481
2773,2337,168,2159,0.9238,0.0719,0.8519,1991,48483
2774,46043,13161,32069,0.6965,0.2859,0.4106,18908,48485
2775,4524,956,3524,0.779,0.2113,0.5677000000000001,2568,48487
2776,5549,3108,2441,0.4399,0.5601,-0.12020000000000003,-667,48489
2777,289534,143795,139729,0.4826,0.4966,-0.014000000000000012,-4066,48491
2778,25014,6350,18463,0.7381,0.2539,0.48419999999999996,12113,48493
2779,2126,358,1753,0.8246,0.1684,0.6562,1395,48495
2780,32366,4973,27032,0.8352,0.1537,0.6815,22059,48497
2781,22778,3509,19049,0.8363,0.154,0.6823,15540,48499
2782,2631,420,2174,0.8263,0.1596,0.6667000000000001,1754,48501
2783,8239,1034,7110,0.863,0.1255,0.7375,6076,48503
2784,3874,1826,2033,0.5248,0.4713,0.05350000000000005,207,48505
2785,4378,2864,1490,0.3403,0.654,-0.31370000000000003,-1374,48507
2786,3100,357,2695,0.8694,0.1152,0.7542,2338,49001
2787,27321,4473,21548,0.7887,0.1637,0.625,17075,49003
2788,58358,16650,38032,0.6517,0.2853,0.36639999999999995,21382,49005
2789,9369,2392,6693,0.7144,0.2553,0.4591,4301,49007
2790,622,111,496,0.7974,0.1785,0.6189,385,49009
2791,173443,57411,104135,0.6004,0.331,0.26940000000000003,46724,49011
2792,8562,843,7513,0.8775,0.0985,0.7789999999999999,6670,49013
2793,4898,572,4207,0.8589,0.1168,0.7421,3635,49015
2794,2732,514,2158,0.7899,0.1881,0.6018000000000001,1644,49017
2795,5205,2806,2248,0.4319,0.5391,-0.10720000000000002,-558,49019
2796,25104,4892,18989,0.7564,0.1949,0.5615,14097,49021
2797,5903,645,5087,0.8618,0.1093,0.7525000000000001,4442,49023
2798,4205,1083,2998,0.713,0.2576,0.45539999999999997,1915,49025
2799,6190,624,5404,0.873,0.1008,0.7722,4780,49027
2800,6606,1086,5181,0.7843,0.1644,0.6199,4095,49029
2801,871,86,773,0.8875,0.0987,0.7888,687,49031
2802,1363,180,1157,0.8489,0.1321,0.7168,977,49033
2803,546602,289906,230174,0.4211,0.5304,-0.10930000000000001,-59732,49035
2804,6904,3113,3535,0.512,0.4509,0.06109999999999999,422,49037
2805,12632,1794,10459,0.828,0.142,0.6859999999999999,8665,49039
2806,10363,1084,9052,0.8735,0.1046,0.7689,7968,49041
2807,26287,15244,10252,0.39,0.5799,-0.18989999999999996,-4992,49043
2808,31519,8943,21014,0.6667,0.2837,0.38299999999999995,12071,49045
2809,15370,1663,13261,0.8628,0.1082,0.7546,11598,49047
2810,289117,76033,192812,0.6669,0.263,0.40390000000000004,116779,49049
2811,17790,6187,10795,0.6068,0.3478,0.259,4608,49051
2812,91160,20530,67294,0.7382,0.2252,0.5129999999999999,46764,49053
2813,1630,365,1229,0.754,0.2239,0.5301,864,49055
2814,112656,40695,65949,0.5854,0.3613,0.22410000000000002,25254,49057
2815,22023,14967,6292,0.2857,0.6796,-0.3939,-8675,50001
2816,20460,12705,7114,0.3477,0.6209,-0.2732,-5591,50003
2817,16167,9011,6551,0.4052,0.5573,-0.1521,-2460,50005
2818,98904,74961,21017,0.2125,0.7578,-0.5453,-53944,50007
2819,3288,1405,1773,0.5392,0.4273,0.1119,368,50009
2820,25828,13611,11274,0.4365,0.5269,-0.09040000000000004,-2337,50011
2821,4851,2905,1810,0.3731,0.5988,-0.2257,-1095,50013
2822,14916,10240,4163,0.2791,0.6866,-0.4075,-6077,50015
2823,17124,10304,6187,0.3613,0.6018,-0.2405,-4117,50017
2824,14095,7147,6512,0.462,0.507,-0.044999999999999984,-635,50019
2825,33971,18230,14672,0.4319,0.5366,-0.10469999999999996,-3558,50021
2826,35302,25191,8928,0.2529,0.7135,-0.4606,-16263,50023
2827,26031,18767,6440,0.2474,0.7208,-0.4734,-12327,50025
2828,34442,23376,9971,0.2895,0.6786,-0.3891,-13405,50027
2829,16963,7578,9172,0.5407,0.4468,0.09389999999999998,1594,51001
2830,64649,42466,20804,0.3218,0.6568,-0.3350000000000001,-21662,51003
2831,8202,2243,5859,0.7143,0.2734,0.44090000000000007,3616,51005
2832,7893,2411,5390,0.6829,0.3055,0.37739999999999996,2979,51007
2833,17004,5672,11041,0.6493,0.3335,0.31579999999999997,5369,51009
2834,9268,2418,6702,0.7231,0.2609,0.46219999999999994,4284,51011
2835,130667,105344,22318,0.1708,0.806,-0.6352,-83026,51013
2836,42277,10840,30714,0.7265,0.2564,0.4701,19874,51015
2837,2501,646,1834,0.7333,0.2583,0.475,1188,51017
2838,48667,12176,35600,0.7315,0.2502,0.48130000000000006,23424,51019
2839,3479,532,2903,0.8344,0.1529,0.6815,2371,51021
2840,21120,5700,15099,0.7149,0.2699,0.445,9399,51023
2841,7947,4552,3357,0.4224,0.5727,-0.1503,-1195,51025
2842,9953,1587,8311,0.835,0.1594,0.6756,6724,51027
2843,8126,3471,4544,0.5592,0.4271,0.13210000000000005,1073,51029
2844,29893,8070,21245,0.7107,0.27,0.4407,13175,51031
2845,16288,7657,8336,0.5118,0.4701,0.041700000000000015,679,51033
2846,15652,2842,12659,0.8088,0.1816,0.6272,9817,51035
2847,4441,2624,1761,0.3965,0.5909,-0.19439999999999996,-863,51036
2848,6191,2317,3815,0.6162,0.3743,0.24189999999999995,1498,51037
2849,203902,106935,93326,0.4577,0.5245,-0.06679999999999997,-13609,51041
2850,9336,3920,5192,0.5561,0.4198,0.13630000000000003,1272,51043
2851,3169,587,2536,0.8003,0.1852,0.6151,1949,51045
2852,27116,10617,16012,0.5905,0.3915,0.199,5395,51047
2853,5310,2227,3019,0.5685,0.4194,0.1491,792,51049
2854,7303,1503,5748,0.7871,0.2058,0.5813,4245,51051
2855,15093,6224,8695,0.5761,0.4124,0.16369999999999996,2471,51053
2856,6178,3038,3075,0.4977,0.4917,0.00599999999999995,37,51057
2857,600788,419943,168401,0.2803,0.6989,-0.41859999999999997,-251542,51059
2858,43663,17565,25106,0.575,0.4023,0.17269999999999996,7541,51061
2859,9408,3004,6225,0.6617,0.3193,0.3424,3221,51063
2860,15841,7414,8155,0.5148,0.4681,0.04670000000000002,741,51065
2861,29701,8381,20895,0.7035,0.2822,0.4213,12514,51067
2862,48706,17207,30558,0.6274,0.3533,0.27409999999999995,13351,51069
2863,9177,2156,6876,0.7493,0.235,0.5143,4720,51071
2864,22281,6964,14875,0.6676,0.3125,0.35509999999999997,7911,51073
2865,16949,6685,9966,0.588,0.3944,0.1936,3281,51075
2866,8131,1535,6529,0.803,0.1888,0.6142000000000001,4994,51077
2867,11311,4163,6866,0.607,0.368,0.239,2703,51079
2868,4573,2627,1914,0.4185,0.5743,-0.15580000000000005,-713,51081
2869,18248,7666,10418,0.5709,0.4201,0.1508,2752,51083
2870,70966,25307,44318,0.6245,0.3566,0.2679000000000001,19011,51085
2871,183141,116572,63440,0.3464,0.6365,-0.29009999999999997,-53132,51087
2872,26104,9127,16725,0.6407,0.3496,0.2911,7598,51089
2873,1533,417,1092,0.7123,0.272,0.4403,675,51091
2874,23455,9399,13707,0.5844,0.4007,0.18370000000000003,4308,51093
2875,49621,25553,23153,0.4666,0.515,-0.0484,-2400,51095
2876,4115,1590,2450,0.5954,0.3864,0.20900000000000002,860,51097
2877,14224,5404,8446,0.5938,0.3799,0.21389999999999998,3042,51099
2878,10736,3260,7320,0.6818,0.3037,0.37809999999999994,4060,51101
2879,7152,3368,3697,0.5169,0.4709,0.04600000000000004,329,51103
2880,9946,1489,8365,0.841,0.1497,0.6913,6876,51105
2881,224837,138372,82088,0.3651,0.6154,-0.25029999999999997,-56284,51107
2882,21916,8269,13294,0.6066,0.3773,0.2293,5025,51109
2883,6000,2418,3537,0.5895,0.403,0.1865,1119,51111
2884,8129,2698,5300,0.652,0.3319,0.32010000000000005,2602,51113
2885,5826,1825,3901,0.6696,0.3133,0.35629999999999995,2076,51115
2886,16205,6803,9266,0.5718,0.4198,0.15199999999999997,2463,51117
2887,6785,2491,4196,0.6184,0.3671,0.25129999999999997,1705,51119
2888,45041,23218,20629,0.458,0.5155,-0.05749999999999994,-2589,51121
2889,9317,4327,4812,0.5165,0.4645,0.051999999999999935,485,51125
2890,14463,4621,9631,0.6659,0.3195,0.34640000000000004,5010,51127
2891,6733,3667,2955,0.4389,0.5447,-0.10579999999999995,-712,51131
2892,7815,3252,4485,0.5739,0.4161,0.15779999999999994,1233,51133
2893,7079,2971,4027,0.5689,0.4198,0.14909999999999995,1056,51135
2894,20741,7995,12426,0.5991,0.3854,0.21369999999999995,4431,51137
2895,12513,3007,9345,0.7468,0.2403,0.5065,6338,51139
2896,9534,1954,7485,0.7851,0.205,0.5801000000000001,5531,51141
2897,34228,10115,23751,0.6939,0.2955,0.3984,13636,51143
2898,19729,5320,14055,0.7124,0.2696,0.4428,8735,51145
2899,9575,4973,4434,0.4631,0.5194,-0.05629999999999996,-539,51147
2900,17431,7103,10103,0.5796,0.4075,0.17210000000000003,3000,51149
2901,228088,142863,81222,0.3561,0.6264,-0.27029999999999993,-61641,51153
2902,17376,4925,12127,0.6979,0.2834,0.4145,7202,51155
2903,4978,2096,2812,0.5649,0.4211,0.14379999999999998,716,51157
2904,4102,1513,2547,0.6209,0.3688,0.2521,1034,51159
2905,57180,21801,34268,0.5993,0.3812,0.21810000000000007,12467,51161
2906,12373,4086,8088,0.6537,0.3302,0.32349999999999995,4002,51163
2907,43813,12644,30349,0.6927,0.2886,0.40409999999999996,17705,51165
2908,13386,2373,10879,0.8127,0.1773,0.6354,8506,51167
2909,10870,1692,9063,0.8338,0.1557,0.6780999999999999,7371,51169
2910,23684,6836,16463,0.6951,0.2886,0.40650000000000003,9627,51171
2911,14137,3008,10963,0.7755,0.2128,0.5627,7955,51173
2912,9787,3969,5730,0.5855,0.4056,0.1799,1761,51175
2913,75312,34307,39411,0.5233,0.4555,0.06779999999999997,5104,51177
2914,79619,40245,37636,0.4727,0.5054,-0.03269999999999995,-2609,51179
2915,4471,2397,2025,0.4529,0.5361,-0.0832,-372,51181
2916,5088,2827,2219,0.4361,0.5556,-0.1195,-608,51183
2917,20134,3205,16731,0.831,0.1592,0.6718,13526,51185
2918,21147,6603,14069,0.6653,0.3122,0.3531,7466,51187
2919,28684,6617,21679,0.7558,0.2307,0.5251,15062,51191
2920,9933,4501,5318,0.5354,0.4531,0.08229999999999998,817,51193
2921,16614,3110,13366,0.8045,0.1872,0.6173,10256,51195
2922,15071,3143,11733,0.7785,0.2085,0.57,8590,51197
2923,38783,17683,20241,0.5219,0.4559,0.066,2558,51199
2924,82496,66240,14544,0.1763,0.8028,-0.6265,-51696,51510
2925,7806,2313,5347,0.685,0.2963,0.38870000000000005,3034,51520
2926,2776,825,1863,0.6711,0.2972,0.3739,1038,51530
2927,24210,20696,3094,0.1278,0.855,-0.7272,-17602,51540
2928,127114,66377,58180,0.4577,0.5222,-0.0645,-8197,51550
2929,9146,2972,6007,0.6568,0.325,0.33180000000000004,3035,51570
2930,2603,964,1580,0.607,0.3703,0.23669999999999997,616,51580
2931,19389,11710,7428,0.3831,0.604,-0.22089999999999999,-4282,51590
2932,2381,1612,754,0.3167,0.677,-0.36030000000000006,-858,51595
2933,13483,9174,4007,0.2972,0.6804,-0.3832,-5167,51600
2934,8817,7146,1490,0.169,0.8103,-0.6413,-5656,51610
2935,4058,2525,1487,0.3664,0.6222,-0.25579999999999997,-1038,51620
2936,12861,8517,4037,0.3139,0.6622,-0.3483,-4480,51630
2937,2638,777,1838,0.6967,0.2945,0.4022,1061,51640
2938,65892,46220,18430,0.2797,0.7014,-0.4217,-27790,51650
2939,17087,11022,5591,0.3272,0.6451,-0.3179,-5431,51660
2940,9608,5430,4020,0.4184,0.5652,-0.14680000000000004,-1410,51670
2941,2762,1791,906,0.328,0.6484,-0.32039999999999996,-885,51678
2942,36361,18048,17097,0.4702,0.4963,-0.026100000000000012,-951,51680
2943,16968,10356,6256,0.3687,0.6103,-0.24159999999999993,-4100,51683
2944,6087,3992,1979,0.3251,0.6558,-0.33070000000000005,-2013,51685
2945,6012,3766,2165,0.3601,0.6263,-0.2662,-1601,51690
2946,81210,53099,26377,0.3248,0.6539,-0.32910000000000006,-26722,51700
2947,89889,64440,23443,0.2608,0.7169,-0.4561,-40997,51710
2948,1601,464,1109,0.6927,0.2898,0.4029,645,51720
2949,14118,12389,1584,0.1122,0.8775,-0.7653,-10805,51730
2950,7857,2054,5605,0.7134,0.2614,0.452,3551,51735
2951,44582,30948,12755,0.2861,0.6942,-0.4081,-18193,51740
2952,6320,3358,2786,0.4408,0.5313,-0.09049999999999997,-572,51750
2953,111131,92175,16603,0.1494,0.8292,-0.6798000000000001,-75572,51760
2954,43329,26773,15607,0.3602,0.618,-0.2578,-11166,51770
2955,13051,5148,7683,0.5887,0.3945,0.19419999999999998,2535,51775
2956,12990,6981,5695,0.4384,0.5374,-0.09899999999999998,-1286,51790
2957,49646,28676,20082,0.4045,0.5777,-0.17319999999999997,-8594,51800
2958,227560,117393,105087,0.4618,0.5159,-0.05410000000000004,-12306,51810
2959,10716,4961,5507,0.5139,0.4629,0.051000000000000045,546,51820
2960,6883,4790,1963,0.2852,0.6959,-0.41069999999999995,-2827,51830
2961,12105,6610,5221,0.4313,0.546,-0.11470000000000002,-1389,51840
2962,5862,1814,3907,0.6665,0.3095,0.357,2093,53001
2963,11951,4250,7319,0.6124,0.3556,0.25680000000000003,3069,53003
2964,103030,38706,60365,0.5859,0.3757,0.2102,21659,53005
2965,43309,19349,22746,0.5252,0.4468,0.07840000000000003,3397,53007
2966,49267,24721,23062,0.4681,0.5018,-0.03370000000000001,-1659,53009
2967,275410,140324,126303,0.4586,0.5095,-0.050899999999999945,-14021,53011
2968,2495,668,1754,0.703,0.2677,0.43529999999999996,1086,53013
2969,60277,23938,34424,0.5711,0.3971,0.17400000000000004,10486,53015
2970,21308,7811,12955,0.608,0.3666,0.2414,5144,53017
2971,4367,1486,2771,0.6345,0.3403,0.29419999999999996,1285,53019
2972,32403,13340,18039,0.5567,0.4117,0.14499999999999996,4699,53021
2973,1489,366,1069,0.7179,0.2458,0.47209999999999996,703,53023
2974,37681,11819,24764,0.6572,0.3137,0.3435,12945,53025
2975,38439,17354,19877,0.5171,0.4514,0.06569999999999998,2523,53027
2976,53926,29213,22746,0.4218,0.5417,-0.11989999999999995,-6467,53029
2977,24789,17204,6931,0.2796,0.6939,-0.41429999999999995,-10273,53031
2978,1210283,907310,269167,0.2224,0.7495,-0.5271000000000001,-638143,53033
2979,158668,90277,61563,0.388,0.569,-0.18099999999999994,-28714,53035
2980,26364,11421,14105,0.535,0.4332,0.10180000000000006,2684,53037
2981,13560,5959,7237,0.5337,0.4395,0.09419999999999995,1278,53039
2982,45308,14520,29391,0.6487,0.3205,0.32820000000000005,14871,53041
2983,7033,1713,5150,0.7323,0.2436,0.4886999999999999,3437,53043
2984,37301,17269,18710,0.5016,0.4629,0.03870000000000007,1441,53045
2985,21283,8900,11840,0.5563,0.4182,0.1381,2940,53047
2986,14064,6794,6953,0.4944,0.4831,0.011300000000000032,159,53049
2987,8553,2593,5728,0.6697,0.3032,0.36649999999999994,3135,53051
2988,464046,249506,197730,0.4261,0.5376,-0.11149999999999999,-51776,53053
2989,13199,9725,3057,0.2316,0.7369,-0.5053,-6668,53055
2990,73424,38252,32762,0.4462,0.521,-0.07480000000000003,-5490,53057
2991,7312,3192,3885,0.5313,0.4365,0.0948,693,53059
2992,438777,256728,166428,0.3793,0.5851,-0.20579999999999993,-90300,53061
2993,295438,135765,148576,0.5029,0.4596,0.043300000000000005,12811,53063
2994,28431,7839,19808,0.6967,0.2757,0.421,11969,53065
2995,168153,96608,65277,0.3882,0.5746,-0.1864,-31331,53067
2996,2981,1165,1741,0.584,0.3908,0.19319999999999998,576,53069
2997,31262,13690,16400,0.5246,0.4379,0.08669999999999994,2710,53071
2998,138630,83660,50489,0.3642,0.6035,-0.2393,-33171,53073
2999,21125,11184,9067,0.4292,0.5294,-0.10019999999999996,-2117,53075
3000,96185,43179,50555,0.5256,0.4489,0.07669999999999993,7376,53077
3001,6677,1457,5116,0.7662,0.2182,0.548,3659,54001
3002,51531,17186,33279,0.6458,0.3335,0.3123,16093,54003
3003,9012,2041,6816,0.7563,0.2265,0.5297999999999999,4775,54005
3004,5664,1457,4120,0.7274,0.2572,0.47020000000000006,2663,54007
3005,10655,2947,7545,0.7081,0.2766,0.43149999999999994,4598,54009
3006,37360,14994,21721,0.5814,0.4013,0.18010000000000004,6727,54011
3007,2971,568,2364,0.7957,0.1912,0.6044999999999999,1796,54013
3008,3365,641,2679,0.7961,0.1905,0.6056,2038,54015
3009,3101,435,2619,0.8446,0.1403,0.7043,2184,54017
3010,16861,5063,11580,0.6868,0.3003,0.38649999999999995,6517,54019
3011,2662,599,2012,0.7558,0.225,0.5308,1413,54021
3012,5509,607,4871,0.8842,0.1102,0.774,4264,54023
3013,15849,4655,10925,0.6893,0.2937,0.3956,6270,54025
3014,10085,1939,8033,0.7965,0.1922,0.6043,6094,54027
3015,13800,3790,9806,0.7106,0.2746,0.436,6016,54029
3016,6331,1381,4859,0.7675,0.2181,0.5494,3478,54031
3017,30465,9215,20683,0.6789,0.3025,0.37639999999999996,11468,54033
3018,13508,3207,10093,0.7472,0.2374,0.5098,6886,54035
3019,27705,12127,15033,0.5426,0.4378,0.10479999999999995,2906,54037
3020,82237,34344,46398,0.5642,0.4176,0.1466,12054,54039
3021,7457,1538,5782,0.7754,0.2062,0.5691999999999999,4244,54041
3022,7830,1711,6012,0.7678,0.2185,0.5493,4301,54043
3023,13026,2333,10534,0.8087,0.1791,0.6295999999999999,8201,54045
3024,6527,1333,5148,0.7887,0.2042,0.5845,3815,54047
3025,25795,8901,16300,0.6319,0.3451,0.2868,7399,54049
3026,14080,3455,10435,0.7411,0.2454,0.4957,6980,54051
3027,11203,2526,8491,0.7579,0.2255,0.5324,5965,54053
3028,25133,5556,19237,0.7654,0.2211,0.5443,13681,54055
3029,12872,2660,10040,0.78,0.2067,0.5733,7380,54057
3030,10022,1397,8544,0.8525,0.1394,0.7131000000000001,7147,54059
3031,42069,20282,20803,0.4945,0.4821,0.012400000000000022,521,54061
3032,6490,1345,5068,0.7809,0.2072,0.5737000000000001,3723,54063
3033,8695,1998,6537,0.7518,0.2298,0.522,4539,54065
3034,10630,2226,8279,0.7788,0.2094,0.5694,6053,54067
3035,19897,7223,12354,0.6209,0.363,0.2579,5131,54069
3036,3659,820,2782,0.7603,0.2241,0.5362,1962,54071
3037,3491,699,2742,0.7854,0.2002,0.5851999999999999,2043,54073
3038,4008,1047,2895,0.7223,0.2612,0.46110000000000007,1848,54075
3039,14572,3163,11190,0.7679,0.2171,0.5508000000000001,8027,54077
3040,28502,7878,20034,0.7029,0.2764,0.4265,12156,54079
3041,33105,7982,24673,0.7453,0.2411,0.5042,16691,54081
3042,12200,3362,8673,0.7109,0.2756,0.43529999999999996,5311,54083
3043,4283,586,3649,0.852,0.1368,0.7152,3063,54085
3044,5763,1455,4213,0.731,0.2525,0.4785,2758,54087
3045,5585,1448,4074,0.7295,0.2593,0.47020000000000006,2626,54089
3046,7383,1796,5477,0.7418,0.2433,0.49850000000000005,3681,54091
3047,3844,938,2841,0.7391,0.244,0.4951,1903,54093
3048,3922,631,3226,0.8225,0.1609,0.6616,2595,54095
3049,10221,2256,7771,0.7603,0.2207,0.5396,5515,54097
3050,16947,4088,12585,0.7426,0.2412,0.5014000000000001,8497,54099
3051,3402,610,2759,0.811,0.1793,0.6317,2149,54101
3052,6667,1539,4993,0.7489,0.2308,0.5181,3454,54103
3053,2653,466,2134,0.8044,0.1757,0.6287,1668,54105
3054,38760,10926,27202,0.7018,0.2819,0.4199,16276,54107
3055,8592,1157,7353,0.8558,0.1347,0.7211000000000001,6196,54109
3056,11819,4329,7362,0.6229,0.3663,0.2566,3033,55001
3057,8757,4801,3841,0.4386,0.5482,-0.10960000000000003,-960,55003
3058,25346,9194,15803,0.6235,0.3627,0.26080000000000003,6609,55005
3059,10879,6147,4617,0.4244,0.565,-0.14059999999999995,-1530,55007
3060,144022,65511,75871,0.5268,0.4549,0.07190000000000002,10360,55009
3061,7816,2860,4834,0.6185,0.3659,0.25260000000000005,1974,55011
3062,10141,3569,6462,0.6372,0.3519,0.2853,2893,55013
3063,30773,12116,18156,0.59,0.3937,0.19629999999999997,6040,55015
3064,35936,13983,21317,0.5932,0.3891,0.20409999999999995,7334,55017
3065,14897,4524,10002,0.6714,0.3037,0.36769999999999997,5478,55019
3066,33868,16410,16927,0.4998,0.4845,0.015300000000000036,517,55021
3067,8696,3953,4620,0.5313,0.4546,0.07669999999999999,667,55023
3068,344681,260121,78794,0.2286,0.7546,-0.526,-181327,55025
3069,48440,16356,31355,0.6473,0.3377,0.3096,14999,55027
3070,20116,10044,9752,0.4848,0.4993,-0.014500000000000013,-292,55029
3071,24679,13218,10923,0.4426,0.5356,-0.09299999999999997,-2295,55031
3072,23523,9897,13173,0.56,0.4207,0.13930000000000003,3276,55033
3073,58269,31620,25341,0.4349,0.5426,-0.10769999999999996,-6279,55035
3074,2940,781,2133,0.7255,0.2656,0.45990000000000003,1352,55037
3075,57252,20588,35754,0.6245,0.3596,0.2649000000000001,15166,55039
3076,5053,1721,3285,0.6501,0.3406,0.3095,1564,55041
3077,25610,10998,14142,0.5522,0.4295,0.12270000000000003,3144,55043
3078,21404,10851,10169,0.4751,0.5069,-0.031799999999999995,-682,55045
3079,10671,3344,7168,0.6717,0.3134,0.35829999999999995,3824,55047
3080,13992,7828,5909,0.4223,0.5595,-0.1372,-1919,55049
3081,4010,1533,2438,0.608,0.3823,0.2257,905,55051
3082,10185,4256,5791,0.5686,0.4179,0.1507,1535,55053
3083,47977,19904,27208,0.5671,0.4148,0.15230000000000005,7304,55055
3084,13709,4746,8749,0.6382,0.3462,0.292,4003,55057
3085,88737,42193,44972,0.5068,0.4755,0.03130000000000005,2779,55059
3086,12095,3976,7927,0.6554,0.3287,0.3267,3951,55061
3087,67891,37846,28684,0.4225,0.5575,-0.135,-9162,55063
3088,8555,3647,4821,0.5635,0.4263,0.1372,1174,55065
3089,11165,3704,7330,0.6565,0.3318,0.3247,3626,55067
3090,16497,6261,10017,0.6072,0.3795,0.22769999999999996,3756,55069
3091,44825,16818,27218,0.6072,0.3752,0.23199999999999998,10400,55071
3092,76753,30808,44624,0.5814,0.4014,0.18000000000000005,13816,55073
3093,22979,7366,15304,0.666,0.3206,0.34540000000000004,7938,55075
3094,9065,3239,5719,0.6309,0.3573,0.2736,2480,55077
3095,1590,1303,278,0.1748,0.8195,-0.6447,-1025,55078
3096,459768,317527,134482,0.2925,0.6907,-0.3982,-183045,55079
3097,22612,8433,13775,0.6092,0.373,0.23619999999999997,5342,55081
3098,23216,6715,16226,0.6989,0.2893,0.40959999999999996,9511,55083
3099,24158,10105,13671,0.5659,0.4183,0.14759999999999995,3566,55085
3100,108020,47667,58385,0.5405,0.4413,0.09919999999999995,10718,55087
3101,61490,26517,33912,0.5515,0.4313,0.12019999999999997,7395,55089
3102,4144,1489,2584,0.6236,0.3593,0.26430000000000003,1095,55091
3103,23317,9796,12815,0.5496,0.4201,0.1295,3019,55093
3104,26371,9370,16611,0.6299,0.3553,0.2746,7241,55095
3105,40604,20428,19299,0.4753,0.5031,-0.02779999999999999,-1129,55097
3106,8546,3032,5394,0.6312,0.3548,0.2764,2362,55099
3107,106446,50159,54479,0.5118,0.4712,0.040600000000000025,4320,55101
3108,9014,3995,4871,0.5404,0.4432,0.09720000000000001,876,55103
3109,85355,46658,37138,0.4351,0.5466,-0.11149999999999999,-9520,55105
3110,7886,2517,5257,0.6666,0.3192,0.3474,2740,55107
3111,56708,23190,32199,0.5678,0.4089,0.15889999999999999,9009,55109
3112,36202,18108,17493,0.4832,0.5002,-0.01699999999999996,-615,55111
3113,10510,4498,5909,0.5622,0.428,0.13420000000000004,1411,55113
3114,22616,7131,15173,0.6709,0.3153,0.3556,8042,55115
3115,66015,27101,37609,0.5697,0.4106,0.15909999999999996,10508,55117
3116,10687,2693,7657,0.7165,0.252,0.4645,4964,55119
3117,15380,6285,8833,0.5743,0.4086,0.16570000000000001,2548,55121
3118,15923,7457,8218,0.5161,0.4683,0.04780000000000001,761,55123
3119,15368,5903,9261,0.6026,0.3841,0.21850000000000003,3358,55125
3120,57599,22789,33851,0.5877,0.3956,0.1921,11062,55127
3121,10379,3867,6334,0.6103,0.3726,0.23769999999999997,2467,55129
3122,88066,26650,60237,0.684,0.3026,0.3814000000000001,33587,55131
3123,268002,103906,159649,0.5957,0.3877,0.20800000000000002,55743,55133
3124,29130,9703,18952,0.6506,0.3331,0.31749999999999995,9249,55135
3125,13568,4388,9016,0.6645,0.3234,0.34109999999999996,4628,55137
3126,94031,44060,47796,0.5083,0.4686,0.03969999999999996,3736,55139
3127,41298,16365,24308,0.5886,0.3963,0.19230000000000003,7943,55141
3128,18618,9092,8579,0.4608,0.4884,-0.027600000000000013,-513,56001
3129,5752,788,4806,0.8355,0.137,0.6985,4018,56003
3130,19565,1935,16975,0.8676,0.0989,0.7687,15040,56005
3131,6664,1427,5014,0.7524,0.2141,0.5383,3587,56007
3132,6970,861,5917,0.8489,0.1235,0.7254,5056,56009
3133,4119,378,3651,0.8864,0.0918,0.7946,3273,56011
3134,18110,5519,12007,0.663,0.3047,0.3583,6488,56013
3135,6241,1203,4878,0.7816,0.1928,0.5888,3675,56015
3136,2577,482,1999,0.7757,0.187,0.5887,1517,56017
3137,4914,897,3881,0.7898,0.1825,0.6073,2984,56019
3138,44985,15217,27891,0.62,0.3383,0.2817,12674,56021
3139,10467,1509,8643,0.8257,0.1442,0.6815,7134,56023
3140,35201,8530,25271,0.7179,0.2423,0.4756,16741,56025
3141,1308,155,1118,0.8547,0.1185,0.7362,963,56027
3142,16716,3410,12813,0.7665,0.204,0.5625,9403,56029
3143,4923,890,3898,0.7918,0.1808,0.611,3008,56031
3144,16428,4043,11843,0.7209,0.2461,0.4748,7800,56033
3145,4970,882,3957,0.7962,0.1775,0.6187,3075,56035
3146,16602,3823,12229,0.7366,0.2303,0.5063,8406,56037
3147,14675,9848,4341,0.2958,0.671,-0.37520000000000003,-5507,56039
3148,9402,1591,7496,0.7973,0.1692,0.6281,5905,56041
3149,4012,651,3245,0.8088,0.1623,0.6465,2594,56043
3150,3542,360,3107,0.8772,0.1016,0.7756,2747,56045
3151,3200,2829,297,0.0928,0.8841,-0.7913,-2532,46113
